I miss you.	Man tevis pietrūkst.
You should sleep.	Tev vajadzētu gulēt.
I'm going to go.	Es iešu.
Are you sure?	Vai tu esi pārliecināts?
It doesn't surprise me.	Tas mani nepārsteidz.
I'm so fat.	Es esmu tik resns.
How long did you stay?	Cik ilgi tu paliki?
You can do it.	Tu to vari.
My physics teacher doesn't care if I skip classes.	Man fizikas skolotāju neuztrauc ja es bastoju stundas.
I wish I could go to Japan.	Es vēlo kaut es varētu doties uz Japānu.
I have to go to bed.	Man vajag iet gulēt.
After that, I left, but then I realized that I forgot my backpack at their house.	Pēc tam, kad es aizgāju, es sapratu, ka esmu aizmirsis savu mugursomu viņu mājā.
I won't ask you anything else today.	Es tev šodien neko citu neprasīšu.
Even though he apologized, I'm still furious.	Pat tad kad viņš atvainojis es joprojām esmu nikns.
Thanks for having explained to me at last why people take me for an idiot.	Paldies tev, ka beidzot paskaidroji, kāpēc cilvēki uzskata mani par muļķi.
That wasn't my intention.	Tas nebija mans nodoms.
Thanks for your explanation.	Paldies par paskaidrojumu.
Theoretically, I'm doing math.	Teorētiski es rēķinu.
It almost scared me not to see you online for a whole day.	Neredzot tiešsaistē veselu dienu, tu mani gandrīz pārbiedēji.
I don't know what you mean.	Es nezinu ko tu ar to domā.
My computer has got to be useful for something.	Manam datoram jābūt noderīgam priekš kaut kā.
You wanted to tell me about freedom?	Tu man vēlējies pastāstīt par brīvību?
Uh, now it's really weird...	Hm, tagad tas ir dīvaini.
No one will know.	Neviens nezinās.
It seems interesting to me.	Man tas liekas intraneti!
I like candlelight.	Man patīk sveču gaisma.
What did you answer?	Ko tu atbildēji?
No, he's not my new boyfriend.	Ne, viņš nav mans jaunais draugs.
It's too bad that I don't need to lose weight.	Tas ir slikti, ka man nevajag zaudēt svaru.
You never have class or what?!	Tev nekad nav bijis klasē vai ne?!
I will play Sudoku then instead of continuing to bother you.	Es spēlēšu sudoki nekā turpināšu garlaikot tevi.
Where is the problem?	Kur ir problēma?
I can only wait.	Es varu tikai gaidīt.
It's not much of a surprise, is it?	Tas nav daudz priekš pārsteiguma, vai ne?
I love you.	Es tevi mīlu.
I don't like you anymore.	Man tu vairs nepatīc.
I am curious.	Es esmu ziņkārīgs.
Congratulations!	Apsveicam!
I don't want to wait that long.	Es negribu gaidīt tik ilgi.
Why don't you come visit us?	Kāpēc tu neapciemo mūs.
But the possibility seems unlikely.	Bet iespēja izskatās mazs ticama.
I shouldn't have logged off.	Man nevajadzēja izlogoties.
Nobody understands me.	Neviens nesaprot mani.
Would you like to dance with me?	Vai jūs vēlaties dejot?
I'm tired.	Es esmu noguris.
Call the police!	Izsauciet policiju!
Merry Christmas!	Priecīgus Ziemassvētkus!
Why do people go to the movies?	Kāpēc cilvēki iet uz kino?
Life is beautiful.	Dzīve ir skaista.
I don't want to go to school.	Negribu iet uz skolu.
She's really smart, isn't she?	Viņa ir ļoti gudra, vai ne?
What are you talking about?	Par ko tu runā.
It's a good deal.	Tas ir labs darījums.
I don't know him.	Es viņu nepazīstu.
How much is it?	Cik tas maksā?
I don't agree with him.	Es viņam nepiekrītu.
What are you doing?	Ko jūs darāt?
You must do it at once.	Tev vajaga beidzot to izdarīt.
You will soon get accustomed to your new school.	Tu drīz iejutīsies savā jaunajā skolā.
Your answer is wrong.	Tava atbilde ir nepareiza.
I was glad to hear of your success.	Es priecājos dzirdēt par taviem panākumiem.
Where is your school?	Kur ir jūsu skola?
I love you more than you love me.	Es mīlu tevi vairāk kā tu mīli mani.
Choose the color you like the best.	Izvēlies krāsu, kura tev patīk vislabāk.
A mirror reflects light.	Spogulis atstaro gaismu.
Are you in a hurry?	Vai tu steidzies?
In 776 B.C., the first Olympic Games were held at the foot of Mount Olympus to honor the Greeks' chief god, Zeus.	776. gadā p.m.ē. pirmās Olimpiskās spēles notika Olimpa kalna pakājē, lai godinātu grieķu galveno dievu - Zevu.
I will gladly help you.	Es tev ar prieku palīdzēšu.
It's time to go to school.	Ir laiks iet uz skolu.
It seems warm outside.	Šķiet ka ārā ir silts.
Is the picture straight?	Vai attēls ir taisni?
I'm glad to see you.	Es esmu priecīgs redzēt jūs.
I'm sick of listening to her complaints.	Man ir apriebies klausīties viņas sūdzībās.
You didn't leave me shit.	Tu man ne sūda neatstāji.
Do you have a plan?	Vai tev ir plāns?
Talking of music, what kind of music do you like?	Runājot par mūziku, kāda mūzika tev patīk?
Leave me alone!	Lieciet mani mierā!
How do you feel?	Kā jūtaties?
All the films are boring.	Visas filmas ir garlaicīgas.
A day has twenty-four hours.	Dienai ir divdesmit četras stundas.
I met her an hour ago.	Es viņu satiku pirms stundas.
What is life without the radiance of love?	Kas ir dzīve bez mīlestības mirdzuma?
Our country is in a crisis.	Mūsu valsts ir krīzē.
Which do you like better, rock music or classical music?	Kāda mūzika tev patīk labāk, rokmūzika vai klasiskā mūzika?
The lion is the king of the jungle.	Lauva ir džungļu karalis.
Have a nice day!	Lai jums laba diena!
Hello, John! How are you?	Sveiks, John! Kā tev iet?
Hello, Tom. Good morning.	Sveiks, Tom. Labrīt.
If I had noticed her, I would have got her autograph.	Ja es būtu viņu pamanījis, es būtu viņai iedevis autogrāfu.
Hello, this is Mike.	Sveiks, tas ir Mike.
I wish I had a better memory.	Es vēlētos lai man būtu labākas atmiņas.
How long have you been living in Tokyo?	Cik ilgi jūs dzīvojat Tokijā?
He's not coming, according to Mary.	Saskaņā ar Mērijas teikto, viņš nenāks.
Meg and Ken sat on the bench.	Mega un Kens sēdēja pludmalē.
Mary is a bookworm.	Marija ir grāmatu tārps.
Bob and Tom are brothers.	Bobs un Toms esam brāļi.
Henry has no more than six dollars.	Henrijam nav vairāk par sešiem dolāriem.
Bell invented the telephone.	Bells izgudroja telefonu.
There is a cat under the bed.	Ir zem gultas kaķis.
The capital of Brazil is Brasilia.	Brazīlijas galvaspilsēta ir Brazilja.
Football is my favorite game.	Futbols ir mana mīļākā spēle.
I need some hangers.	Man vajag dažus pakaramos.
The child was hiding behind a big tree.	Bērns slēpās aiz liela koka.
It was a mouse.	Tas bija pele.
Why?	Kādēļ?
Why do I feel this way?	Kāpēc es šādi jūtos?
Tom is playing the violin now.	Toms šobrīd spēle vijoli.
Tom doesn't like cheese.	Toms nepatīk sieru.
Is a tomato a fruit or a vegetable?	Vai tomāts ir auglis vai dārzenis?
Tony lives in Kobe.	Tonijs dzīvo Kobe.
Please give me another chance.	Lūdzu, dodiet man vēl vienu iespēju.
The door is opened every morning.	Durvis ir atvērtas katru rītu.
Can you help me a little?	Vai tu man varētu nedaudz palīdzēt?
I am sad to hear it.	Man ir skumji to dzirdēt.
They are our cars.	Tās ir mūsu mašīnas.
It was such an interesting book that I read it in a day.	Tā bija tik interesanta grāmata, ka es to izlasīju vienā dienā.
It will cost around 10,000 yen.	Tas maksās aptuveni 10000 jēnu.
Keep away from that.	Turies pa gabalu no tā.
It was the first time that I visited the museum.	Tā bija pirmā reize, ka es apmeklēju muzeju.
What do you mean by that?	Ko tu ar to domā?
This problem is difficult to solve.	Šo problēmu ir grūti atrisināt.
The soldier was wounded in the leg.	Karavīrs tika ievainots kājā.
The war lasted two years.	Karš ilga divus gadus.
The teacher told us a funny story.	Skolotājs mums izstāstīja smieklīgu stāstu.
The dog didn't eat the meat.	Suns neapēda gaļu.
As soon as the dog saw me, it began to bark.	Tiklīdz kā suns mani ieraudzīja, tas sāka riet.
Finishing the report by tomorrow is next to impossible.	Līdz rītdienai pabeigt atskaiti ir gandrīz neiespējami.
And then he sat down himself.	Tad viņš apsēdās pats.
I'm sorry, I'm busy right now.	Es atvainojos, es šobrīd esmu aizņemts.
That's too much!	Tas ir par daudz.
Susie can type many times as fast as I can.	Sūzija spēj rakstīt daudz ātrāk kā es.
Jack Daniel's is a Tennessee whiskey.	Jack Daniel's ir Tenesī viskijs
After a while she began to play the piano again.	Pēc kāda laika, viņa atkal sāka spēlēt klavieres.
Jane couldn't explain the beauty of snow.	Džeina nespēja izskaidrot sniega skaistumu.
Hello, Tom.	Sveiks, Tom.
This is the pen that he signed the document with.	Šī ir tā pildspalva ar kuru viņš parakstīja dokumentus.
This is a present for you.	Šī ir dāvana jums.
Can you tell me what this is?	Vai tu vari man pateikt, kas tas ir?
Is this book yours?	Vai šī grāmata ir tava?
This box contains five apples.	Šī kastē ir pieci āboli.
This watch is waterproof.	Šis rokaspulkstenis ir ūdensizturīgs.
This lake is the deepest in Japan.	Šis ezers ir dziļākais Japānā.
Are there any Japanese restaurants near here?	Vai šeit tuvumā ir kāds Japāņu restorāns?
This flower is very beautiful.	Šis zieds ir ļoti skaists.
I'm listening to this band.	Es klausos šo grupu.
This is the house in which the prime minister lives.	Tas ir māja, kurā premjerministrs dzīvo.
Ken beat me at chess.	Kens uzvarēja mani šahā.
Where are your credit cards?	Kur ir tava kredītkarte?
Today is Sunday.	Šodien ir svētdiena.
The line is busy.	Līnija ir aizņemta.
We haven't seen you in the past four years.	Pēdējos četrus gadus mēs neesam tevi redzējuši.
The sun is shining brightly.	Saule spīd spoži.
Let's have lunch.	Ēdīsim pusdienas!
What about your manners!	Kas tas par teikumu!
Good morning, Mike.	Labrīt, Mike.
I have a stomachache.	Man ir sāpes kuņģī.
My uncle lives in Madrid, the capital of Spain.	Mans onkulis dzīvo Madridē, galvas pilsētā Spānijā.
I'm fine, thank you.	Paldies, man klājas labi.
Whiskey goes very well with tea.	Viskijs ļoti labi iet kopā ar tēju.
Happy Easter!	Priecīgas Lieldienas!
It's too dark to play baseball now.	Ir pārāk tumšs, lai tagad spēlētu beisbolu.
I hear you're very rich.	Es dzirdēju, ka jūs esat ļoti bagāts.
Will you go with us?	Vai jums iet ar mums?
You have a good memory.	Jums ir labas atmiņas.
You've got a great sense of humor.	Tev piemīt lieliska humora izjūta.
When are you busy?	Ja tu esi aizņemts?
What is your name?	Kā tevi sauc?
You were seen to cook.	Tu biji redzēts gatavojot.
She said 'I love you' to me.	Viņa man pateica 'Es mīlu tevi'.
I know him.	Es viņu zinu.
That guy is always asking his parents for money.	Tas puisis vienmēr prasa viņa vecākiem naudu.
A gang of three robbed the bank in broad daylight.	Trīs cilvēku banda skaidrā dienas laikā aplaupīja banku.
A year has twelve months.	Gadam ir divpadsmit mēnešu.
I'll be back in an hour.	Es būšu atpakaļ pēc stundas.
"Does he like music?" "Yes, he does."	"Vai viņam patīk mūzika?" "Jā, viņam patīk."
"Could you do this instead of me?" "Sorry, I'm too busy."	''Vai tu to varētu izdarīt manā vietā?'' ''Piedod, es esmu pārāk aizņemts.''
"What does U.F.O. stand for?" "It means Unidentified Flying Object, I guess."	"Ko nozīmē NLO?" - Man šķiet, ka tas ir "neidentificēts lidojošs objekts".
Hello, how are you?	Sveiks, kā tev klājas?
How tall is your brother?	Cik garš ir tavs brālis?
The police got to the scene of the accident.	Policija nokļuva negadījuma vietā.
A whale is a mammal.	Valis ir zīdītājs.
Good luck.	Laimīgs gadījums! Veiksmi!
What is the unemployment rate at the moment?	Kāds šobrīd ir bezdarba līmenis?
The fund was set up to help orphans.	Fonds tika izveidots, lai palīdzētu bāreņiem.
Strike while the iron is hot.	Kal dzelzi, kamēr iā karsta.
Fortunately, the weather was good.	Par laimi, laiks ir labs.
We protested, but it was in vain.	Mēs protestējām, bet tas bija veltīgi.
He was wearing black trousers and a beautiful white shirt.	Viņš valkāja melnas bikses un skaistu baltu kreklu.
I'm very sleepy now.	Es esmu ļoti miegains tagad.
I have nothing on this weekend.	Man nav nekā ieplānota šonedēļ.
Hello, I am Nancy.	Sveiks, es esmu Nancy.
It is Monday today.	Šodien ir pirmdiena.
I had a horrible dream last night.	Man bija slikts sapnis pagājušajā naktī.
I did not watch TV but studied English last night.	Es vakarnakt neskatījos televizoru, bet mācījos angļu valodu.
The sunrise from the mountaintop was beautiful beyond description.	Saullēkts no kalna virsotnes bija neaprakstāmi skaists.
The population is dying off.	Iedzīvotāji izmirst.
Our plan went wrong from the beginning.	Mūsu plāns jau sākumā nogāja greizi.
Let's keep beautiful nature around us.	Turēsim skaistu dabu ap mums.
We are afraid.	Mēs baidāmies.
We chose her a nice birthday present.	Mēs izvēlējāmies viņai jauku dzimšanas dienas dāvanu.
We live in peace.	Mēs dzīvojam mierā.
I have no time.	Man nav laika.
In my opinion, it would be difficult to solve this problem.	Pēc manām domām, tas varētu būt grūti atrisināt šo problēmu.
My hobby is taking pictures of wild flowers.	Mans hobijs ir fotografēt savvaļas puķes.
My birthday is in November.	Mana dzimšanas diena ir novembrī.
My father is busy.	Mans tēvs ir aizņemts.
I'll show you my room.	Es tev parādīšu savu istabu.
My mother is on a diet.	Mana māte ir par diētu.
Will you take care of my dog while I am away?	Vai tu parūpēsies par manu suni kamēr es būšu prom?
I am a student.	Es esmu students.
I waited for ten minutes.	Es gaidīju desmit minūtēm.
I want the same jacket as you are wearing.	Es gribu to pašu jaku, kuru tu valkā.
I love you more deeply than I can say.	Es tevi mīlu daudz vairāk kā to varu izteikt vārdos.
I live in an apartment.	Es dzīvoju dzīvoklī.
I know that money isn't everything.	Es zinu, ka nauda nav viss.
I like tea.	Es mīlu tēju.
I can play soccer.	Es varu spēlēt futbolu.
I don't want to participate in the ceremony.	Es nevēlos piedalīties ceremonijā.
Where am I?	Kur es esmu?
I'm a baker.	Esmu maiznieks.
I don't want to live by myself.	Es negribu dzīvot viens pats.
I am listening to the music.	Es paklausos dziesmu.
I often study while listening to music.	Es bieži studēju, klausoties mūziku.
I have to cook dinner today.	Man šodien jāpagatavo vakariņas
I wrote a letter.	Es uzrakstīju vēstuli.
I built a new house.	Es uzcēla jaunu māju.
I am a teacher.	Es esmu skolotājs.
I go to school by subway.	Es dodos uz skolu ar metro.
I'm afraid of earthquakes.	Es baidos no zemestrīces.
I want to talk to her.	Es gribu sarunāties ar viņu.
Though I am tired, I will work hard.	Lai arī es esmu noguris, es strādāšu cītīgi.
I am tired and I want to go to bed.	Es esmu noguris un vēlos iet gulēt.
When we are in good health, we are apt to forget its value.	Kad mums ir laba veselība, mēs viegli aizmirstam tās vērtību.
We had to wait for him for ten minutes.	Mums vajadzēja viņu gaidīt desmit minūtes.
If you have a chance, please check your mailbox.	Ja tev ir iespēja, lūdzu pārbaudi savu pastkasti.
To tell the truth, I don't like him.	Es saku taisnību man viņš nepatīk.
The front windshield of a car was smashed to pieces.	Automašīnas vējstikls tika sadauzīts gabalos.
Small businesses are often absorbed by a major company.	Mazus uzņēmumus bieži pārņem liela kompānija.
Give variety to your meals.	Piešķir dažādību saviem ēdieniem.
Mari and Maki are sisters.	Maria un Makija ir māsas.
Parents love their children.	Vecāki mīl savus bērnus.
Willingness to take responsibility is a sign of maturity.	Vēlme uzņemties atbildību ir brieduma pazīme.
A man's heart is about as large as his fist.	Cilvēka sirds ir aptuveni tikpat liela kā viņa dūre.
Humans can't live on Mars.	Cilvēki nevar dzīvot uz Marsa.
The people rebelled against the king.	Tauta sacēlās pret ķēniņu.
He kept silent all the time during the interrogation.	Viņš klusēja visu nopratināšanas laiku.
Vinegar has a sharp taste.	Etiķis ir asa garša.
Read the book aloud.	Lasi grāmatu skaļi.
A green banana is not ripe enough to eat.	Zaļš banāns nav pietiekoši nogatavojies, lai to ēstu.
It is white as snow.	Tas ir balts kā sniegs.
Watch your step. The stairs are steep.	Skaties, kur liec kāju. Kāpnes ir stāvas.
What percentage of the students are admitted to colleges?	Procentuāli cik studentu tiek uzņemti koledžās?
Who did it?	Kurš to izdarīja?
I forget who said it.	Es aizmirsu kurš to teica.
Go and see who it is.	Ej un paskaties kas tas ir.
Is it a boy or a girl?	Vai tas zēns vai meitene?
The earth is round.	Zeme ir apaļa.
There used to be big trees around the pond.	Apkārt dīķim kādreiz bija lieli koki.
The birds flew to the south.	Putniņi lidoja uz dienvidiem.
Don't tramp in the living room with muddy feet.	Nepiestampā dzīvojamo istabu ar dubļainām kājām.
It's dangerous to walk on railway lines.	Staigāt pa dzelzceļa līnijā, ir bīstami.
In comparison with Tokyo, London is small.	Salīdzinājumā ar Tokiju, Londona ir maza.
Tokyo has an extremely high volume of traffic.	Tokijā ir ļoti liela satiksme.
Naturally.	Dabiski.
Some people relax by reading.	Daži cilvēki atpūšas lasot.
I have no time even for reading.	Man nav laika pat lasīšanai.
Do not cast pearls before swine.	Neber cūkām pērles
We have a lot of snow in February.	Februārī mums ir daudz sniega.
Japan is full of surprises!	Japāna ir pārsteigumu pilna!
The cat slept on the table.	Kaķis gulēja uz galda.
The white boat went down the stream.	Baltā laiva devās lejup pa straumi.
There are some eggs in the box.	Tur ir dažas olas kastē.
He has a brother and two sisters.	Viņam ir brālis un divas māsas.
He has a loud voice.	Viņam ir skaļa balss.
All his efforts seemed to have been wasted.	Visas pūles likās veltīgas.
He has been studying French for eight years.	Viņš ir mācījies Franču valodu astoņus gadus.
He doesn't even drink beer, not to mention whiskey.	Viņš nedzer pat alu, nemaz nerunājot par viskiju.
He can't walk any more.	Viņš vairs nevar pastaigāt.
He was known to everybody in the village.	Viņu zināja ikviens ciematā.
He was elected captain of the team.	Viņš tika ievēlēts par komandas kapteini.
He seems very busy. I can't come into contact with him.	Viņš liekas aizņemts. Es nevaru ar viņu sazināties.
Has he come yet?	Vai viņš jau ir atnācis?
He is a teacher of English.	Viņš ir angļu valodas skolotājs.
He is a type of a person who calls a spade a spade.	Viņš ir tāds cilvēks, kurš sauc lietas īstajos vārdos.
He has never been abroad.	Viņš nekad nav bijis ārzemēs.
He'll be glad to see you.	Viņš priecāsies tevi redzēt.
He hid himself behind the door.	Viņš paslēpās aiz durvīm.
He missed the last train.	Viņš nokavēja pēdējo vilcienu.
He used his umbrella as a weapon.	Viņš izmantoja savu lietussargu kā ieroci.
He came from a tiny mountain town.	Viņš nāca no mazas kalnu pilsētiņas.
He was standing at the top of the mountain.	Viņš stāvēja kalna galotnē.
He was to dine with us.	Viņš bija pusdienot kopā ar mums.
He tried writing a short story.	Viņš centās rakstīt noveli.
He accepted our offer.	Viņš pieņēma mūsu piedāvājumu.
He sent his luggage in advance.	Viņš jau iepriekš nosūtīja savu bagāžu.
He is not the sort of man who counts on others for help.	Viņš nav tāds cilvēks, kurš paļaujas uz citu palīdzību.
He goes to sleep with the lights left on.	Viņš iet gulēt, atstājot gaismas ieslēgtas.
He will be punished.	Viņš tiks sodīts.
He is too tired to study.	Viņš ir pārāk noguris, lai mācītos.
He was tired, and yet he went to help them.	Viņš bija noguris, tomēr viņš devās viņiem palīdzēt.
He looks tired.	Viņš izskatās noguris.
He may have missed the plane.	Viņš var nokavēt lidmašīnu.
He begged his father to buy him a bicycle.	Viņš lūdza tēvam nopirkt velosipēdu.
They resemble each other in all respects.	Viņi visos aspektos viens otram līdzinās.
I will wait until she comes.	Es gaidīšu kamēr viņa atnāks.
She didn't need to come.	Viņai nevajadzēja nākt.
Her kindness touched me.	Viņas laipnība mani aizkustināja.
She is a doctor.	Viņa ir ārste.
She was intelligent as well as beautiful.	Viņa bija inteliģenta kā arī skaista.
Will she get well soon?	Vai viņa drīz atlabs?
She asked how to cook the fish.	Viņa jautāja, kā pagatavot zivi.
She knocked on the door.	Viņa pieklauvēja pie durvīm.
She dressed up for the party.	Viņa ir saģērbusies ballītei.
The flowers cheered her up.	Ziedi viņu uzmundrināja.
It is said that she is rich.	Tas ir skumji ka viņa ir bagāta.
She is busy with the care of her children.	Viņa nodarbojas ar bērnu audzināšanu.
She avoids me.	Viņa izvairas no manis.
She has good handwriting.	Viņai ir labs rokraksts.
She has something in her hand.	Viņa ir kaut kas rokā.
She made a promise to write to me every week.	Viņa man solīja rakstīt katru nedēļu.
Critics may argue that all the foregoing characterizations are very abstract.	Kritiķī var strīdēties par to, ka visi iepriekšminētie raksturojumi ir ļoti abstrakti.
He seemed to be ill.	Viņš izskatījās saslimis.
May I go with you?	Vai es drīkstu jūs pavadīt ?
I was terribly frightened.	Es biju ļoti nobijies.
It's just a cold.	Tā ir tikai saaukstēšanās.
It's not my fault.	Tā nav mana vaina.
I got nervous on the stage.	Uz skatuves es kļuvu nervozs.
Real friendship is more valuable than money.	Patiesa draudzība ir vērtīgāka par naudu.
Time for dinner.	Laiks vakariņām.
You may come with us if you want to.	Tu vari nākt ar mums, ja vēlies.
What is the date today?	Kāds šodien datums?
Good evening.	Labvakar.
Have a nice trip!	Laimīgu ceļu!
What is the weather like today?	Kāds laiks šodien?
I have many friends.	Man ir daudz draugu.
May I ask your name?	Vai es varētu pajautāt kā tevi sauc.
Who is he?	Kas viņš ir.
Hello, Chicago!	Sveiks, Čikāga!
My hovercraft is full of eels.	Mans gliseris ir pilns ar zušiem.
I'm sorry, I love you.	Piedod, es tevi mīlu.
See you later!	Uz redzēšanos.
Happy New Year!	Laimīgu Jauno gadu!
I am a vegetarian.	Es esmu veģetārietis.
The road is long.	Ceļš ir garš.
Where are you from?	No kurienes jūs esat?
The sun is shining.	Saulīte spīd.
Do you need this book?	Vai tev vajag šo grāmatu?
Hello!	Sveiks.
He climbed down from the tree.	Viņš nokāpa no koka.
Thank you!	Paldies!
I don't understand.	Es nesaprotu.
We found a turtle in the garden.	Mēs atradām bruņurupucis dārzā.
Do you speak English?	Vai jūs runājat angliski?
I play the piano.	Es spēlēju klavieres.
I don't have a spare shirt.	Man nav lieka krekla.
The bell rang.	Zvans nozvanīja.
If you say, "I love you," then I will also say that to you.	Ja tu teiksi ''Es mīlu tevi''tad es to pašu teikšu arī tev.
I'll stay at home tomorrow.	Es rīt palikšu mājās.
This is the house where she used to live.	Šī ir tā māja kurā viņa dzīvoja.
I'll always remember your kindness.	Es vienmēr atcerēšos tavu laipnību.
She was almost hit by a car.	Viņu gandrīz notrieca mašīna.
It was his habit to get up early.	Tas bija viņa ieradums pamosties agri.
I'm three years younger than he is.	Es esmu trīs gadus jaunāks par viņu.
Hello, world!	Sveika pasaulē!
If he'd known the truth, he'd have told me.	Ja viņš būtu zinājis patiesību, viņš man būtu pateicis.
Yes, how much do they cost?	Jā. Cik tie maksā?
I couldn't understand his ideas.	Es nevarēju saprast viņa idejas.
What's your name?	Kā tevi sauc?
One, two, three, four, five, six, seven, eight, nine, ten.	Viens, divi, trīs, četri, pieci, seši, septiņi, astoņi, deviņi, desmit.
Before you give orders, you must learn to obey.	Pirms tu dod pavēles, tev jāiemācās pakļauties.
I started writing the book.	Es sāku rakstīt grāmatu.
Good night!	Ar labu nakti!
She let him drive on his own.	Viņa viņam ļāva braukt pašam.
What time is it?	Cik ir pulkstenis?
I understand.	Es saprotu.
I know not with what weapons World War III will be fought, but World War IV will be fought with sticks and stones.	Es nezinu, ar kādiem ieročiem cilvēki cīnīsies Trešajā pasaules karā, bet Ceturtajā pasaules karā viņi cīnīsies ar nūjām un akmeņiem.
Do you have children?	Vai jums ir bērni?
He pays with a credit card.	Viņš maksā ar kredītkarti.
Help!	Palīgā!
Thanks!	Paldies!
Thank you.	Paldies!
Thanks.	Paldies!
I can't understand why he did that.	Es nesaprotu kāpēc viņš tā darija.
Whose turn is it?	Kura kārta ir?
It's now your turn.	Tagad ir tava kārta.
He earns his living by writing.	Viņš nopelna viņa dzīvei rakstot
Don't you touch me, you'd make me dirty!	Neiztiec mani, tu padari mani netīru!
The road is straight, but the slope is steep.	Ceļš ir taisns, bet slīpums ir stāvs
How can you avoid the dangers of the Internet?	Kā var izvairīties no briesmām no interneta.
Say it clearly in a loud voice.	Saki to skaidri skaļā balsī.
You are absolutely right, Mr Prime Minister!	Jums pilnībā ir taisnība ministra prezidenta kungs!
It's too big.	Tas ir par lielu.
It's too large.	Tas ir lielu.
I wonder if keeping your head down and living safely is a survival instinct.	Es brīnos, ja turot savu galvu uz leju un dzīvojot droši ir izdzīvošanas instinkts?
That shop has many customers.	Veikalam ir daudz apmeklētāku.
I'm worried for you.	Es esmu noraizējies par tevi.
I hate coffee.	Es ienīstu kafiju.
I'll attend.	Es ieradīšos.
We really enjoyed ourselves.	Mēs patiešām patika sevi.
I dislike coffee.	Man nepatīk kafija.
What name will be given to the child?	Kāds vārds tiks dots bērnam?
I borrow money.	Es aizņēmos naudu.
I buy tapes.	Es nopirku lentes
I like math.	Man patīk matemātika.
I like mathematics.	Man patīk matemātika.
You'll understand once you come of age.	Jūs sapratīsiet kad jūs paliksiet vecāki.
That guy got married and started a family.	Tas vīrietis apprecējās un sāka dibināt ģimeni
Long live the Soviet Union!	Ilgi dzīvo Padomju Savienībā!
How's it going? Are you busy?	Kā iet? Vai tu esi aizņemts?
They really did win.	Viņi tiešām neuzvarēja.
Tomorrow, we shave for free.	Rīt mēs noskūsimies par brīvu.
Calm down.	Nomierines.
That's good, isn't it?	Tas ir labi, vai ne?
He's making a lot of money in the stock market.	Viņš pelna daudz naudas akciju tirgū.
My nickname is "Itch."	Mana iesauka ir ''Itch.''
Large, isn't it?	Liels, vai ne?
This place is large, isn't it?	Šī vieta ir liela, vai ne?
You won't regret it!	Jūs nenožēlosiet!
There is a traffic jam on the highway.	Uz šosejas ir satiksmes sastrēgums.
What colour was Henri IV's white horse?	Kāda krāsa bija Henrija IV baltais zirgs?
He's a good guy now, so he'll make a good husband in the future.	Viņš ir labs vīrietis tagad tātad viņš būs labs vīrs nākotnē.
Would you like to drink a bit tonight?	Vai tu gribētu dzert šovakar?
Let me pay tonight.	Ļauj man spēlēt šovakar.
Now, this is a problem.	Tagad tā ir problēma.
Prices have dropped recently.	Cena ir kritusies nesen.
I pray that you will have the best of luck.	Es lūdzu, lai jums būtu veiksme.
Yesterday was Sunday.	Vakar bija Svētdiena.
He drank a lot yesterday.	Viņš dzēra daudz vakar.
He can speak Russian, too.	Viņš ari var runāt Krieviski.
I want you to dry my tears.	Es vēlos lai tu noslauki manas asaras.
I wonder if this is love.	Es domāju vai tā ir mīlestība.
Could you teach me how to play the piano?	Vai tu man iemācīsi kā spēlēt klavieres?
What's in your mind?	Kas ir tavā prātā.
I am the State!	Es esmu valstī!
Please come in.	Ludzu nāc iekšā.
It's very cold.	Ir ļoti auksti.
That's an imitation.	Tā ir imitācija.
That's a fake.	Tas ir neīsts.
Wait just a moment.	Pagaidi mirkli.
I love parties.	Es mīlu ballītes.
Everyone, please be quiet.	Visi lūdz esat klusi.
That's a good question.	Tas ir labs jautājums.
Lemons are sour.	Citroni ir skābi.
Has something happened?	Vai kaut kas ir noticis?
It's an easy victory.	Tā ir viegla uzvara.
Do it now.	Dariet to tagad.
It's great! You'll laugh for sure.	Tas ir lieliski! Jūs smieties, noteikti.
You don't have to eat it.	Tev nevajag to ēst.
Everyone dies.	Visi mirst.
Life is enjoyable.	Dzīve ir patīkama.
Life is fun.	Dzīve ir smieklīga.
Clean your room.	Iztīri savu istabu.
There are also fish that fly.	Ir arī zivs kas lido.
It's free.	Tas ir bezmaksas.
It's improved.	Tās ir uzlabojies.
This book isn't as heavy as that book.	Šī grāmata nav tik smaga kā tā grāmata.
My TV has quit working.	Mans TV ir pārstājis darboties.
I agree.	Es domāju tāpat.
I am very sorry.	Man ļoti žēl.
I'll kill you.	Es tevi nogalināšu.
I shave every morning.	Es skūšanās katru rītu.
She's our neighbour.	Viņa ir mūsu kaimiņiene.
This flag is very beautiful.	Šis karogs ir ļoti skaista.
Octopus Paul was right.	Astoņkājis Pols bija taisnība.
He likes playing football.	Viņam patīk spēlēt futbolu.
Happy birthday!	Daudz laimes; dzimšanas dienā!
After Saturday comes Sunday.	Pēc sestdienas nāk svētdiena.
It's raining.	Ārā līst.
Please write it down.	Vai jūs nevarētu Lūdzu to uzrakstīt?
Pleased to meet you.	Priecājos ar Jums iepazīties
She has sunglasses.	Viņai ir saulesbrilles.
This is his house.	Tas ir viņa mājas.
They are eating a sandwich.	Viņi ēd sendviču.
This is my book.	Tā ir mana grāmata.
What is it made of?	No kā tas ir izgatavots?
What is the exchange rate?	Kāds ir valūtas maiņas kurss?
He gave him a book.	Viņš iedeva viņam grāmatu.
This is the house where I was born.	Šī ir māja, kurā es piedzimu.
I was wrong.	Es kļūdījos.
My mistake.	Mana kļūda.
How are you going?	Kā jums klājas?
I hate when other people make me wait a long time.	Man nepatīk, ka citi cilvēki liek man ilgi gaidīt.
It's good now; neither too heavy nor too light.	Tagad ir labi; ne par smagu, ne par vieglu.
Yes.	Jā.
My father works in a factory.	Mans tēvs strādā rūpnīcā.
Where are my wings?	Kur ir mani spārni.
Hate hates hate.	Naids ienīst naidu.
Please go to the playground to play.	Lūdzu ej uz spēļu laukumu spēlēties.
I never dreamed that I would meet you.	Es nekad nesapņoju ka tevi satikšu.
Cheers!	Uz veselību!
Nobody lives in this house.	Šajā mājā neviens nedzīvo.
You can trust him.	Tu vari viņam uzticēties.
She was washing the dishes.	Viņa mazgāja traukus.
I'm in a hurry.	Jā, steidzos.
I don't like cold coffee.	Man nepatīk auksta kafija.
I think I lost my keys.	Es domāju, ka es pazaudēju savas atslēgas.
There is no god but God, and Muhammad is the messenger of God.	Nav pielūgsmes objekta kā vien Dievs, un apliecinu, ka Muhammeds ir Dieva vēstnesis.
She came home very late.	Viņa atnāca mājās ļoti vēlu.
I usually get up at 8.	Es parasti ceļos astoņos.
When did you come back from London?	Kad tu atgriezies no Londonas?
I don't remember how tall you are.	Es neatceros cik garš tu esi.
Look! The train has arrived!	Skaties! Vilciens ir atbraucis!
There are more important things in life.	Dzīvē ir svarīgākas lietas.
The capital of the United States of America is Washington, D.C.	Amerikas Savienoto Valstu galvaspilsēta ir Vašingtona.
Where is my dad?	Kur ir mans tētis?
One language is never enough.	Ar vienu valodu nekad nepietiek:
Do you come here often?	Vai tu šeit nāc bieži?
Ten, twenty, thirty, forty, fifty, sixty, seventy, eighty, ninety, hundred.	Desmit, divdesmit, trīsdesmit, četrdesmit, piecdesmit, sešdesmit, septiņdesmit, astoņdesmit, deviņdesmit, simts.
At five I was already able to ski.	Piecu gadu vecumā es jau varēju slēpot.
My school is near to the station.	Mana skola ir netālu no stacijas.
His brother is married but he hasn't any children.	Viņa brālis ir precējies, bet viņam nav bērnu.
Facebook eats up a lot of my time.	Facebook man nozog daudz laika.
My mother is crazy.	Mana māte ir traka.
I didn't do my homework.	Es neizpildīju savus mājasdarbus.
Learning a foreign language is interesting.	Apgūt svešvalodu ir interesanti.
I don't want to read this book.	Es nevēlos lasīt šo grāmatu.
What did you do this summer?	Ko tu šovasar darīji?
I studied Chinese at the University of Venice.	Es studēju ķīniešu valodu Venēcijas Universitātē.
Take a paper and write!	Paņem papīru un raksti!
You remember things more easily than me.	Tu lietas atceries vieglāk kā es.
She bought a vacuum cleaner at the supermarket.	Lielveikalā viņa nopirka putekļu sūcēju.
Dogs can't tell colors apart.	Suņi nespēj atšķirt krāsas.
She walked twenty miles a day.	Viņa nogāja divdesmit jūdzes dienā.
This house and this land is mine!	Šī māja un šī zeme ir mana!
After climbing Mt Fuji I got the inspiration for a poem.	Pēc uzkāpšanas Fuji kalnā, es guvu iedvesmu uzrakstīt dzejoli.
I hope to see reindeer on my trip to Sweden.	Sava ceļojuma uz Zviedriju laikā, es ceru ieraudzīt ziemļbriedi.
Who is the owner of this car?	Kurš ir šīs mašīnas īpašnieks?
Correct!	Pareizi!
We agree.	Mēs piekrītam.
She's way taller than me.	Viņa ir daudz garāka par mani.
You are a singer.	Tu esi dziedātājs.
Are you done washing your hands?	Tu pabeidzi mazgāt rokas?
It belongs to my brother.	Tas pieder manam brālim.
Translating sentences on Tatoeba is more fun than doing homework.	Teikumu tulkošana "Tatoebā" ir jautrāka kā mājasdarbu pildīšana.
Daijisen and Daijirin are very similar.	Daijisen un Daijirin ir ļoti līdzīgi.
We're almost like brothers.	Mēs esam gandrīz kā brāļi.
We're just like brothers.	Mēs esam gluži kā brāļi.
I'm thinking of you.	Es domāju par tevi.
I love you, too.	Es tevi arī mīlu.
Man cannot live forever.	Cilvēks nevar dzīvot mūžīgi.
Where did it happen?	Kur tas notika?
If only I was younger.	Ja vien es būtu jaunāks.
In Japan, practically every family has a washing machine.	Japānā praktiski katrai ģimenei ir veļas mašīna.
Sometimes a dog can be a dangerous animal.	Dažkārt suns var būt bīstams dzīvnieks.
Ten, twenty, thirty, forty, fifty, sixty, seventy, eighty, ninety, one hundred.	Desmit, divdesmit, trīsdesmit, četrdesmit, piecdesmit, sešdesmit, septiņdesmit, astoņdesmit, deviņdesmit, simts.
He likes to run.	Viņam patīk skriet.
She has seven sons.	Viņai ir septiņi dēli.
Get well soon!	Veseļojies drīz!
I don't give a shit.	Man ir pie pakaļas.
A week has seven days.	Nedēļā ir septiņas dienas.
The rain washed away the soil.	Lietus aizskaloja augsni.
I asked him where I could park my car.	Es viņam jautāju, kur es varētu novietot mašīnu.
I'm really sorry.	Man ir ļoti žēl.
Tom appeared confused.	Toms izskatījās apmulsis.
Tom isn't being careful.	Toms nav piesardzīgs.
It's dangerous to dive in shallow water.	Tas ir bīstami, nirt seklā ūdenī.
Addition and subtraction are functions of mathematics.	Saskaitīšana un atņemšana ir matemātiskās funkcijas.
The earth's moon is a natural satellite.	Zemes mēness ir dabīgais pavadonis.
Cows eat grass.	Govis ēd zāli.
Of course I remember you, we used to be best friends when we went at elementary school!	Protams, ka es tevi atceros, mēs bijām labākie draugi, kad mācījāmies pamatskolā!
Ask her when she comes back.	Pajautā viņai kad viņa atgriezīsies.
Who sings that song?	Kas dzied šo dziesmu?
I don't give a fuck.	Man ir pie dirsas.
She sat on the bed as her mother braided her hair.	Viņa apsēdās uz gultas, kad māte pina viņas matus.
Colorless green ideas sleep furiously.	Bezkrāsainas zaļas idejas vētraini guļ.
It's a quarter to three.	Pulkstenis ir bez piecpadsmit minūtēm trīs.
Tell it to him, not me!	Saki to viņam, nevis man!
Happy Mother's Day!	Laimīgu Mātes diena!
Dog is man's best friend.	Suns ir cilvēka labākais draugs.
Doctor, my stomach hurts.	Ārst, man ir sāpes kuņģī.
Can you forgive me?	Vai vari man piedot?
What has he done today?	Ko viņš šodien ir izdarījis?
The earth is smaller than the sun.	Zeme ir mazāka nekā Saule.
Step back, Satan!	Atkāpies, Sātan!
What's the time?	Cik ir pulkstenis?
He's my brother.	Viņš ir mans brālis.
Call Tom immediately.	Zvani Tomam nekavējoties.
Should I wait for you here?	Vai man tevi vajadzēja gaidīt šeit?
Silence is golden.	Klusums ir zelta.
Your brother will not buy it.	Tavs brālis to nepirks.
Three children opened the door of the building.	Trīs bērni atvēra ēkas durvis.
I am afraid.	Es esmu nobijies.
I have a house.	Man ir nams.
That's a total lie.	Tie ir vieni vienīgi meli.
More and more students are joining the protests.	Vairāk un vairāk studentu pievienojas protestiem.
They did not have enough gold.	Viņiem nebija pietiekoši daudz zelta.
They wanted to live in peace with the Indians.	Viņi ar Indiāņiem gribēja dzīvot mierā.
Did he support her idea?	Vai viņš atbalstīja viņas ideju.
The two sides signed a peace treaty.	Abas puses parakstīja miera līgumu.
It's so obvious that it's a lie!	Tas ir acīmredzami, ka tie ir meli!
I drank milk.	Es dzēru pienu.
Some even accused him of treason.	Daži pat apsūdzēja viņu nodevībā.
I have a hammer, and I'm not afraid to use it!	Man ir āmurs, un es nebaidos to likt lietā.
The magazine declares a new king of hipster "music" every two weeks.	Žurnāls pasludina jaunu hipsteru "mūzikas" karali ik pēc divām nedēļām.
I know what I'll do.	Es zinu, ko es darīšu.
I got the flu.	Man ir gripa.
Shizuko composed a poem about the change of the seasons.	Šizuko sarakstīja poēmu par gadalaiku maiņu.
I hate you.	Es tevi ienīstu.
He speaks Russian.	Viņš runā krieviski.
Stick it up your arse.	Iebāz to sev dirsā.
Pleased to meet you. I am an anteater.	Prieks iepazīties. Es esmu skudrulācis.
Hello everyone!	Sveiki visiem!
She is a whore.	Viņa ir mauka.
The dog is close to death.	Suns ir tuvu nāvei.
I can do it without your help.	Es varu to izdarīt bez tavas palīdzības.
Interesting.	Intresanti.
A king's daughter is a princess.	Ķēniņa meita ir princese.
You've bitten off more than you can chew.	Tu esi nokodies vairāk nekā tu vari sakošļāt.
How many do you want?	Cik cik daudz tu gribi?
That man is French. Are you and your sister, too?	Tas vīrietis ir francūzis. Vai tu un tava māsa arī esat?
This cat is black. Is the dog, too?	Šis kaķis ir melns. Vai suns arī?
Do they have any good news?	Vai tev ir labi jaunumi.
We should study together.	Mums vajadzētu mācīties kopā.
She advised him to cut down on smoking.	Viņa ieteica viņam mazāk smēķēt.
She asked him to stay, but he had to go to work.	Viņa lūdza viņam palikt, bet viņam bija jāiet uz darbu.
She hates him.	Viņa viņu ienīst.
She walked past him without even noticing him.	Viņa pagāja viņam garām, pat viņu neievērojot.
I want to die with Getter Jaani.	Es gribu mirt ar Getter Jaani.
We all speak English.	Mēs visi runājam angļu valodā.
I understand your language.	Es saprotu jūsu valodu.
Seeing the son of a whore throwing rocks at a crowd, he said: "Be careful, you could hit your father."	Redzot maukas dēlu metam akmeņus cilvēku pūlī, viņš teica: "Uzmanies, tu vari trāpīt savam tēvam."
Nothing makes us greater than a great suffering.	Nekas nepadara dižākus kā lielas ciešanas.
I've had a lot on my mind lately.	Es pēdējā laikā esmu daudz ko pārdomājis.
Magdalena and Ania are good friends.	Magdalena un Ania ir labas draudzenes.
We prefer to stay here.	Mēs labāk paliksim šeit.
What is important for you?	Kas tev ir svarīgs?
I have a comfortable house.	Man ir ērta māja.
He awoke me early in the morning.	Viņš mani pamodināja agri no rīta.
He quietly said goodbye.	Viņš klusi teica uz redzēšanos.
She has an ancient family name.	Viņai ir sens uzvārds.
Next Thursday is a holiday.	Nākamā ceturtdiena ir brīvdiena
She has lost all hope.	Viņa ir zaudējusi visas cerības
I tore the newspaper into pieces.	Es saplēsu avīzi druskās.
All will be fine.	Būs jau labi.
I didn't understand what you said.	Es jūs nesapratu!
I didn't want it!	Es tā negribēju!
When is the next guided tour?	Kad būs nākamā ekskursija ar gidu?
Cheers! Good health!	Uz veselību! Priekā!
Merry Christmas and a Happy New Year!	Priecīgus Ziemassvētkus un laimīgu Jauno gadu!
How much is this?	Cik tas maksā?
Do you speak Latvian?	Vai jūs runājat latviski?
Please say that again!	Lūdzu, pasakiet to vēlreiz!
Please speak more slowly!	Lūdzu, runājiet lēnāk!
Is there someone here who speaks English?	Vai te ir kāds, kas māk angļu valodu?
Do you speak... English?	Vai jūs runājat... angliski?
It is too expensive.	Tas ir pārāk dārgi.
Have you got something cheaper?	Vai jums ir kas lētāks?
There's a mistake in the bill.	Rēķinā ir kļūda
I am fine, thank you.	Paldies, man iet labi.
I have run out of money.	Man nav naudas.
I have lost my friends.	Es esmu pazaudejis savus draugus
I've lost my friends.	Es esmu pazaudejis savus draugus
I have got beautiful eyes.	Tev ir skaistas acis.
What can I get you for drinking?	Ko tu dzersi?
One beer, please!	Vienu alu, ludzu!
I learn by heart.	Es mācos no galvas.
For me it is not yet known.	Man tas vēl nav zināms.
I teach English to someone.	Es mācu kādam angļu valodu.
Listen here!	Paklau!
I'm listening to the music.	Es paklausos dziesmu.
You have no taste.	Tu esi bezgaršīgam.
You're too young to die, my friend.	Tu esi par jaunu lai mirtu mans draugs.
Maja Keuc is a good singer.	Maja Keuc ir labs dziedātājs.
Can you remember the first word you learned in English?	Vai tu atceries pirmo vārdu, kuru tu iemācījies angļu valodā?
I hate myself for not having the will power to quit eating junk food.	Es ienīstu sevi, ka man nav gribasspēka atmests ātro ēdienu ēšanu.
Welcome to Tatoeba, tequila, sex and marijuana.	Laipni lūdzam Tatoebā, tekila, sekss un marihuāna.
We shouldn't judge people based on their appearance.	Mums nevajadzētu spriest par cilvēkiem, balstoties uz to, kā viņi izskatās.
You need to stop talking all the time and start listening to what others say.	Tev vajadzētu beigt runāt visu laiku un sākt klausīties to, ko es saku.
I'm reading this book.	Es lasu šo grāmatu.
Please lock the safe.	Lūdzu aizslēdz seifu.
I hate the world because the world hates me.	Es ienīstu pasauli, jo pasaule ienīst mani!
Ken isn't brave enough to try again.	Kens nav pietiekoši drosmīgs, lai mēģinātu atkal.
Hi, my name is Pekka. What is your name?	Sveiki, mani sauc Pekka. Kā tevi sauc?
Helsinki is the capital of Finland.	Helsinki ir Somijas galvaspilsēta.
This medicine is still not sold in pharmacies.	Šīs zāles joprojām netiek pārdotas aptiekās.
Tom put his bags in the trunk, then hopped in the car and drove off.	Toms ielika savas somas bagāžniekā, tad ieleca mašīnā un aizbrauca.
Tom is studying French.	Toms mācās Franču valodu.
Tom is left-handed, but he writes with his right hand.	Toms ir kreilis, bet viņš raksta ar labo roku.
Tom has good eyesight.	Tomam ir laba redze.
Tom enjoys listening to live music.	Toms patīk klausīties dzīvajā mūzikā.
Tom can't read without glasses.	Toms nevar lasīt bez brillēm.
Tom almost always goes to work by car.	Toms gandrīz vienmēr uz darbu dodas ar mašīnu.
Tom smuggled a bottle of whiskey into Mary's hospital room.	Toms pa kluso ienesa viskija pudeli Mērijas palātā.
Tom pushed Mary off the diving board.	Toms nogrūda Mēriju no tramplīna.
I like the Occitan language.	Es mīlu oksitāņu valoda.
We are just about the same age.	Mēs esam vienā vecumā.
I watch TV every day.	Es skatos televizoru katru dienu.
You're in Europe!	Jums ir Eiropā!
Music is his passion.	Mūzika ir viņa kaislība.
He has a black shirt.	Viņs ir melns krekls.
Tom was fucking Mary while translating this sentence on his Android device.	Toms drātēja Mēriju, vienlaicīgi tulkodams šo teikumu caur "Android" ierīci.
Today the sea was warm!	Šodien jūra bija silta.
I didn't forget.	Es neaizmirsu.
Tom seems to have lost his key.	Toms izskatās ka ir pazaudējis savas atslēgas.
Tom didn't know that Mary had already bought bread.	Toms nezināja, ka Marija jau bija nopirkusi maizi.
Tom bought new laces for his shoes.	Toms nopirka jaunas šņores savām kurpēm.
The sun is big.	Saule ir liela.
I sent you a letter.	Es tev nosūtīju vēstuli.
All apples are red.	Visi āboli ir sarkani.
The way is long.	Ceļš ir garš.
I know nothing about women.	Es neko nezinu par sievietēm.
The meeting will end tomorrow.	Sanāksme beigsies rīt.
Let's get married.	Precamies!
It's almost time to go.	Ir gandrīz jau laiks doties projām.
Tom wanted to wash his hands.	Toms gribēja nomazgāt rokas.
How is that possible?	Kā tas ir iespējams?
He read the letter she mailed to him over and over again, but still did not understand it.	Viņš atkal un atkal pārlasīja vēstuli, kuru viņa bija nosūtījusi viņam, bet joprojām to neizprata.
All of my attempts have failed.	Visi mani mēģinājumi ir izgāzušies.
I try not to think about it.	Es mēģinu par to nedomāt.
Tom locked his keys in his car.	Toms ieslēdza savas atslēgas mašīnā.
I entered her room.	Es iegāju viņas istabā.
We need your support.	Mums vajag jūsu atbalsu.
Don't touch me!	Neaizskar mani!
What do you say?	Ko jūs sakāt?
Tom hasn't changed very much.	Toms nav daudz mainījies.
I think he must go there.	Es domāju ka viņam ir jājiet tu.
I'm not a doctor.	Es neesmu ārsts.
I enlisted in the Air Force.	Es brīvprātīgi pievienojāties Gaisa spēku.
If you want to cry, cry.	Ja tu gribi raudāt, raudi.
Are you boring? Sorry, are you bored?	Vai tu esi garlaicīgs? Piedod, vai tev ir garlaicīgi?
Horses are animals.	Zirgi ir dzīvnieki.
Where are your keys?	Kur ir jūsu atslēgas?
That restaurant's too expensive.	Tas restorāns ir pārāk dārgs.
I love American food.	Es mīlu amerikāņu pārtiku.
Nancy is very cute, isn't she?	Nancija ir ļoti gudra vai ne.
Crocodiles have sharp teeth.	Krokodili ir asiem zobiem.
What should I do now?	Ko lai es tagad daru?
What is the time?	Cik ir pulkstenis?
Clean the table already!	Notīri beidzot galdu!
When an English speaker realises that a foreign person they are speaking to doesn't understand one of their sentences, they repeat it, the same way, but louder, as though the person were deaf. At no point does it come to their mind that their vocabulary might be complicated or that their expression might most probably be ambiguous to a foreigner and that they could reword it in a simpler way. The result is that not only does the person still not understand, but they get irritated at being considered deaf.	Kad angliski runājošais pamana, ka ārzemnieks, ar kuru viņš runā, nesaprot kaut ko no viņa teiktā, viņš atkārto tieši to pašu, bet skaļāk, it kā šis cilvēks būtu kurls. Nevienā brīdī viņam neienāk prātā, ka viņa vārdu izvēle varētu būt sarežģīta, vai ka viņa izteiciens varētu būt ārzemniekam viegli pārprotams, un ka viņš varētu to pateikt vienkāršāk ar citiem vārdiem. Rezultātā, cilvēks ne tikai joprojām nesaprot sacīto, bet arī kļūst aizkaitināts par to, ka tiek uzskatīts par kurlu.
He didn't order dinner yet.	Es vel nepasūtīju vakariņas.
I don't feel well today.	Es šodien nejūtos labi.
Tatoeba was temporarily unavailable.	Tatoeba bija īslaicīgi nav pieejams.
He loves music.	Viņš mīl mūziku.
He looked small next to my heavyset father.	Viņš izskatījās mazs stāvot blakus manam lielajam tēvam.
I am in the garden.	Esmu dārzā.
He lives in Morocco.	Viņš dzīvo Marokā.
Who wants to be a millionaire?	Kurš vēlas būt miljonārs?
Do you really have free tickets for the concert?	Vai patiešām ir bezmaksas biļetes uz šo koncertu.
Bob was just about to leave when I telephoned him.	Bobs jau gatavojās doties prom, kad es viņam piezvanīju.
Stay!	Paliec!
I want to have a sword!	Es gribu zobenu!
I'll study hard tomorrow.	Es rīt cītīgi mācīšos
I waited for fifteen minutes.	Es gaidīju piecpadsmit minūtes.
The captain, his whore, women and children first!	Kapteinis, viņa mauka, sievietes un bērni pa priekšu!
I want to send this by registered mail.	Es gribu nosūtīt šo no reģistrēta epasta.
Burj Khalifa is currently the tallest skyscraper in the world.	Burj Khalīfah pašlaik ir pasaulē augstākais debesskrāpis.
The couple have seven children.	Pārim ir septiņi bērni.
With all due respect, Mr. President, you are an asshole!	Ar visu cieņu, prezidenta kungs, jūs esat smerdelis!
Faith works miracles!	Ticība dara brīnumus!
Life is a mirror!	Dzīve ir spogulis!
I am very happy in Georgia.	Es esmu ļoti laimīgs Gruzijā.
I will stay until the end.	Es palikšu līdz beigām.
They crossed the border.	Viņi šķērsojuši robežu.
They became very nervous.	Viņi kļuva ļoti nervozi.
Do you require our help?	Vai tev vajag mūsu palīdzību.
A good question.	Labs jautājums.
Are you Tom?	Vai jūs esat Toms?
Never talk to strangers.	Nekad nerunāt ar svešiniekiem.
You'll have to learn all these dates by rote.	Tev būs jāpatur prātā visi šie datumi.
They know what happened.	Viņi zin, kas notika.
I have a white cat.	Man ir balts kaķis.
Tom is a good neighbour.	Toms ir labs kaimiņš.
Your son is a genius.	Tavs dēls ir ģēnijs.
I won't tell anyone.	Es nevaru pateikt nevienam.
I saw her yesterday.	Es viņu vakar redzēju.
The Rosetta Stone was found in 1799.	Rosetta akmens tika atrasts 1799.
I gave up on receiving the unpaid salary.	Es atmetu cerības saņemt nesamaksāto algu.
I confirmed the order.	Es apstiprināju pasūtījumu.
What's the best sleeping position?	Kāds ir labākais gulēšanas veids?
Recently we have had several disasters.	Pēdējā laikā mums ir bijušas vairākas nelaimes.
Tom fucked up again.	Toms atkal visu sapisa.
We climbed to the top.	Mēs uzkāpām līdz virsotnei.
I think you are mistaken.	Es domāju, ka tu kļūdies.
We're in trouble.	Mums ir nepatikšanas.
How much do you want to sell this for?	Par cik tu gribi pārdot šo.
Did you try to listen to her?	Vai tu mēģināji viņā ieklausīties?
Give me your book.	Iedod man savu grāmatu!
Who sings this song?	Kas dzied šo dziesmu?
All the apples are there.	Visi āboli ir tur.
I want to write a book.	Gribu rakstīt grāmatu.
Sometimes things that happen do not make sense.	Dažreiz notiekošais ir neizprotams.
The devil is in the details.	Sātans slēpjas detaļās.
He took the proper steps to meet the situation.	Viņš spēra īstos soļus attiecīgajai situācijai.
We have a lot of time.	Mums ir daudz laika.
What's happened?	Kas notika?
You're in danger.	Jūs esat briesmās.
He knows the truth.	Viņš zina patiesību.
We can't give up now.	Mēs nevaram padoties.
I love you - I love you too.	Es mīlu tevi - es arī mīlu tev.
You don't know that.	Tu to nezini.
We won't forgive you.	Mēs jums nepiedos.
Mary is Tom's girlfriend.	Marijas draugs ir Toms
This is the first time I've ever stamped a document.	Šī ir pirmā reize, kad es apzīmogo dokumentu.
I cannot plant trees here. This land is too dry.	Es nevaru stādīt kokus šeit. Šī zeme ir pārāk sausa.
I know that he knows.	Es zinu, ka viņš zin.
She's in the shower.	Viņa ir dušā.
They're young and healthy.	Viņi ir jauni un veselīgi.
What time do you arrive at work?	Kādā laikā tu ierodies darbā?
When I got home, I had a nice, ice-cold shower.	Kad es tiku mājās, es iegāju jaukā, ledainā dušā.
We've been there before.	Mēs jau tur esam bijuši.
Law doesn't protect the fools.	Likums muļķus nesargā.
This is unbearable.	Tas ir nepanesamas.
The air is damp.	Gaiss ir mitrs.
I have to shake hands with the President.	Man jāpaspiež roka prezidentam.
He's a professional photographer.	Viņš ir profesionāls fotogrāfs.
He knows everything about Germany.	Viņš zin visu par Vāciju.
Our teacher is a real idiot.	Mūsu skolotājs ir reāls idiots.
He has wine.	Viņam ir vīns.
They have wine.	Viņiem ir vīns.
He's a gardener.	Viņš ir dārznieks.
I am your father.	Es esmu tavs tēvs.
I'm your father.	Es esmu tavs tēvs.
Do you want to see my translations?	Vai vēlaties redzēt savu tulkojumu?
Excuse me if I call you an asshole, but that's what I think you are.	Atvainojiet mani, ja es jūs nosaucu par smerdeli, bet tas ir tas, ko es par jums domāju.
How did he find us?	Kā viņš mūs atrada?
I hate computers.	Es ienīstu datorus.
Nobody wants you to be happy.	Neviens vēlas, lai jūs būtu laimīgs.
Armenia is a mountainous country.	Armēnija ir kalnaina valsts.
We all want you to be happy.	Mēs visi vēlamies, lai jūs būtu laimīgs.
What's wrong with my sentences?	Kas vainas maniem teikumiem?
She doesn't want you to know.	Viņa nevēlas, lai tu zinātu.
They don't want you to know.	Viņi nevēlas, lai tu zini.
Here is my heart.	Te ir mana sirds.
I need the money.	Man vajag naudu.
My parents know my girlfriend.	Mani vecāki zina manu draudzeni.
Get back here.	Nāc atpakaļ.
I'll set you free.	Es tevi atbrīvošu.
Let me do my job.	Ļauj man darīt savu darbu.
Where is the cat?	Kur ir kaķis?
Give a man a fish and you feed him for a day. Teach a man to fish and you feed him for a lifetime.	Iedod cilvēkam zivi un viņš būs paēdis vienu dienu. Iemāci cilvēkam ķert zivis un viņš būs paēdis visu mūžu.
I don't live in Finland.	Es nedzīvoju Somijā.
We need few words to express what is essential.	Mums nepieciešami daži vārdi, lai pateiktu to, kas ir būtisks.
Tom won't stay.	Toms nepaliks.
Tom just couldn't help himself.	Toms nevarēja palīdzēt sev.
Tom is disappointed.	Toms ir vīlies.
Tom is dead.	Toms ir miris.
Tom is confused.	Toms ir apjucis.
Tom is coming back.	Toms atgriezīsies.
Tom is behind you.	Toms ir aiz tevis.
Tom is barely alive.	Toms ir knapi dzīvs.
Tom is back in town.	Toms ir atgriezies.
Tom is awfully quiet today.	Toms šodien ir diezgan klus.
Tom is at the door.	Toms ir pie durvīm.
Tom is at the bar.	Toms ir pie bāra.
Tom is at the airport.	Toms ir pie lidostas.
Tom is asleep on the couch.	Toms ir aizmidzis uz dīvāna.
Tom is angry now.	Toms ir dusmīgs.
Tom is an orphan.	Toms ir bārenis.
Tom is an old friend.	Toms ir mans vecs draugs.
Tom is already there.	Toms jau ir šeit.
Tom is already in Boston.	Toms jau ir Bostonā.
Tom is about to go.	Toms tulīt ies.
Tom is a smart kid.	Toms ir gudrs zēns.
Tom is a great kid.	Toms ir labs puika.
Tom is a good friend.	Toms ir labs draugs.
Tom is a billionaire.	Toms ir miljardieris.
Tom hung up the phone.	Toms nolika klausuli.
Tom has passed out.	Toms ir atslēdzies.
Tom doesn't live here.	Toms šeit nedzīvo.
You must join me.	Tev vajag man piebiedroties.
She is making a mountain out of a molehill.	Viņa izpūta no mušas ziloni.
We did nothing wrong.	Mēs neizdarījām neko sliktu.
She opened like this.	Viņa atvēra šādā veidā.
I can't sing.	Es nevaru dziedāt.
Am I disturbing you?	Vai es jūs netraucēju?
Why are people afraid of the police?	Kāpēc cilvēki baidās no policijas?
Where's my tea?	Kur ir mana tēja?
Where are they?	Kur viņi ir?
I don't think you understand.	Es nedomāju, ka tu saproti.
I think you're nice.	Es domāju, ka tu esi jauks.
She's very open.	Viņa ir ļoti atklāta.
We don't have time for this.	Mums tam nav laika.
You have plenty of time.	Tev ir daudz laika.
You can wait here.	Tu vari gaidīt šeit.
You always seem tired.	Tu vienmēr izskaties noguris.
That's not going to help.	Tas nelīdzēs.
That's not my fault.	Tā nav mana vaina.
This wasn't an easy decision for us.	Šis mums nebija viegls lēmums.
Maybe we should be quiet.	Varbūt mums vajadzētu būt klusiem.
I don't want to hear another word about it!	Es nevēlos dzirdēt nevienu vārdu par to!
I see my table.	Es redzu savu galdu.
One cannot embrace the unembraceable.	Neviens nevar apskaut neapskaujamo.
Would you like to see it?	Vai tu gribētu redzēt to.
I refuse to answer.	Es atsakos atbildēt.
Sun and rain, rainbow.	Saule un lietus, varavīksne.
I'm not your mother.	Es neesmu jūsu māte.
Take off your clothes.	Noģērbieties!
He told me to meet him at the restaurant.	Viņš pateica lai es viņu satieku restorānā.
I can't help you do that.	Es nevaru tev palīdzēt to izdarīt.
You can't hypnotize me.	Tu nespēj mani hipnotizēt.
I can't just do nothing.	Es varu nedarīt neko.
I can't recall who said that.	Es nevaru atcerēties kurš to teica.
His son is sick.	Viņa dēls ir slims.
What do you want from Tom?	Ko jūs vēlaties no Toms?
Is your daughter here?	Vai tava meita ir šeit.
I thought the show was excellent.	Es domāju, ka šovs bija lielisks.
I don't have many friends.	Man nav daudz draugu.
My dad will kill me.	Mans tēvs mani nogalinās.
Get out of bed.	Ārā no gultas!
I won!	Es uzvarēju!
Let's not go to class.	Neiesi uz klasi.
I read a letter.	Es lasīju vēstuli.
Nobody wants a war.	Neviens negrib karu.
I don't want you to worry.	Es negribu lai tu uztrauktos.
I don't want to get you in trouble.	Es nevēlos tevi ievilkt nepatikšanās.
I want you to know that I love you.	Es gribu lai tu zini ka es tevi mīlu.
I didn't want to tell Tom about this.	Es nevēlējos Tomam stāstīt par šo.
We don't want anyone to find us here.	Mēs negribam lai mūs šeit kāds atrod.
Zero, one, two, three, four, five, six, seven, eight, nine, ten.	Nulle, viens, divi, trīs, četri, pieci, seši, septiņi, astoņi, deviņi, desmit.
I love you and I want to marry you.	Es mīlu tevi un gribu tevi precēt.
I want you to take it away from Tom.	Es gribu lai tu to paņēm no Toma.
Now's the time to decide if you want to go with us or not.	Tagad ir laiks izlemtu vai tu vēlies iet ar mums, vai nē.
What I really want is for Tom to teach me how to play a few chords on my guitar.	Ko es patiešām gribu, lai Toms man iemāca, kā spēlēt dažus akordus uz mana ģitāras.
I'm happy to hear it.	Es priecājos to dzirdēt.
Let me introduce you to my beautiful wife.	Ļauj mani iepazīstināt ar manu skaisto sievu.
We have to be very careful.	Mums jābūt ļoti uzmanīgiem.
Totoro says: "I can't speak Chinese."	Totoro saka: "Es nerunāju ķīniešu."
Something terrible's happened.	Noticis kaut kas šausmīgs.
Do you remember this game?	Vai jūs atceraties šo spēli?
I would like to learn Latvian.	Es gribētu mācīties latviešu valodu.
I'm a cat.	Es esmu kaķis.
Tom goes to school by foot.	Toms iet uz skolu kājām.
There are two plates on the table.	Ir divas plāksnes uz galda.
We sprinkle salt to ward off bad luck.	Mēs birdinām sāli, lai atgaiņātu nelaimi.
Does anybody know where Tom is?	Vai kāds zina, kur ir Toms?
Where is my son?	Kur ir mans dēls?
Where's my son?	Kur ir mans dēls?
Of course, I haven't seen all marijuana users. But marijuana use causes temporary stupidity. Everyone knows that.	Protams, ka es neesmu redzējis visus marihuānas lietotājus. Taču marihuānas lietošana izraisa īslaicīgu stulbumu. To zin visi.
I love my city.	Es mīlu savu pilsētu.
I'm innocent, I swear.	Es esmu nevainigs, es zveru.
Never write the words "bortsch" and "shchi" in German!	Nekad nerakstiet vārdus "borščs" un "svaigu kāpostu zupa" vācu valodā!
The Bering Strait separates Asia from North America.	Beringa šaurums atdala Āziju no Ziemeļamerikas.
We're sinking.	Mēs esam grimst.
Take cover!	Slēpes!
No wonder that the presenter sounded weird, she was sick.	Nav brīnums, ka prezentētāja izklausījās dīvaini, viņa bija saslimusi.
I'm at the beach.	Esmu pie pludmales.
It is hard to speak in public.	Ir grūti runāt publiski.
His words excited everyone, even the opposition.	Viņa vārdi aizrāva visus, pat opozīciju.
Have you noticed anything suspicious?	Vai tu esi ievērojis kaut ko aizdomīgu.
She has good sense.	Viņai ir laba izjūta.
The book is on the table.	Grāmata ir uz galda.
Any questions?	Kādi jautājumi?
Do you have it?	Vai tev tas ir?
We went for a walk on the beach.	Mēs devāmies pastaigā pa pludmali.
War is hell.	Karš ir elle.
We're afraid.	Mēs baidāmies.
We're dedicated.	Mēs esam izlēmuši.
Are you surprised?	Vai tu esi pārsteigts?
Tom is all alone again.	Toms atkal ir pilnīgi viens.
I'm Tom's neighbor.	Es esmu Toma kaimiņš.
Tom is stable.	Toms ir stabils.
Tom kept running.	Toms turpināja skriet.
Tom kept screaming.	Toms turpināja kliegt.
Tom kept sighing.	Toms turpināja dziedāt.
Tom kept silent.	Toms turpināja klusēt.
Tom kept singing.	Toms turpināja dziedāt.
Tom kept smiling.	Toms turpināja smaidīt.
Tom kept staring.	Toms turpināja lukoties.
Tom kept talking.	Toms turpināja runāt.
Tom resumed speaking.	Toms atsāka runāt.
Tom resuscitated Mary.	Toms atdzīvināja Mariju.
Tom returned fire.	Toms šāva pretīm.
Tom returned home.	Toms atgriezās mājās.
Tom returned immediately.	Toms atgriezās uzreizs.
Tom rushed in.	Toms ieskrēja iekšā.
Tom rushed upstairs.	Toms steidzās aukšup pa kapnēm.
Tom said goodnight.	Toms pateica ar labunakti.
Tom said something.	Toms pateica kautko.
Tom said that.	Toms pateica to.
Tom sat alone.	Toms sēdēja viens.
Tom sat calmly.	Toms sēdēja mierīgi.
Tom sat down.	Toms apsēdās.
Tom sat impatiently.	Toms apsēdās uzreiz.
Tom sat nearby.	Toms apsēdās tuvu.
Tom seems bored.	Toms izskatās garlaikots.
Tom stayed outside.	Toms palika ārā.
A samurai's blood runs in Taro's veins.	Caur Taro vēnām plūst samuraja asinis.
We'll send somebody.	Mēs kādu aizsūtīsim.
They helped Tom.	Viņi palīdzēja Tomam.
They resumed walking.	Viņi turpināja iet.
They suspected nothing.	Viņi neko nenojauš.
They won't come.	Viņi nenāks.
Aren't we friends?	Vai mēs neesam draugi?
I sat down.	Es apsēdos.
I'll find somebody.	Es kādu atradīšu.
That's great news.	Tās ir lieliskas ziņas.
That's your opinion.	Tā ir tava izvēle.
I saw it from the window.	Es to ieraudzīju no loga.
Were you prepared?	Jūs bijāt gatavi?
When's your birthday?	Kad ir tava dzimšanas diena?
You may speak.	Tu vari runāt.
You'll stay here.	Tu paliksi šeit.
You've lost weight.	Tu pazaudēji svaru.
Good evening!	Labvakar!
He came in and immediately sat down.	Viņš atnāca un uzreiz apsēdās.
I need a box of nails.	Man vajag naglu kasti.
That's the question we have to solve.	Tas ir jautājums, kuru mums ir jāatrisina.
The plate slipped out of my hands.	Šķīvis izslīdēja viņam no rokām.
We should lock the door when we leave.	Mums vajadzētu aizslēgt durvis, kad mēs aizejam.
As a result of new ultra-light materials, our product now only weighs about half as much as before!	Dēļ ultravieglajiem materiāliem mūsu produkts tagad sver apmēram uz pusi mazāk kā iepriekš!
I didn't even ask.	Es pat nejautāju.
Tom didn't hear anything.	Toms nedzirdēja neko.
Tom seems different today.	Toms šodien izskatās savādāk.
You don't work here.	Tu šeit nestrādā.
You explained that well.	Tu to labi izskaidroji.
You'll sleep better tonight.	Šonakt tu gulēsi labāk.
I don't have the option.	Man nav izvēli.
I'm going to study.	Es studēšu.
What part don't you understand?	Kuru daļu tu nesaproti?
You didn't miss a thing.	Tu neko nenokavēji.
He kept his word.	Viņš turēja savu vārdu.
I assumed there must be something else we had to do.	Es pieņemu, ka bija vēl kaut kas, ko mums vajadzēja izdarīt.
I brought you this.	Es tev atnesu šo.
The cat caught the mouse.	Kaķis nozvejotas peli.
I need a taxi!	Man vajag taksi!
I can't explain that.	Es nevaru to paskaidrot.
I can't let Tom keep doing that.	Es nevaru ļaut Tomam turpināt to darīt.
She forgot to lock the door.	Viņa aizmirsa aizslēgt durvis.
Can you close the door?	Vai tu vari aizvērt durvis?
We became good friends.	Mēs kļuvām par labiem draugiem.
I drink to relax.	Es dzeru lai relaksētos.
I found the key in Tom's jacket pocket.	Es atradu atslēgu Toma jakas kabatā.
I had to go back.	Man vajadzēja iet atpakaļ.
He is no longer at home.	Viņš vairs nav mājās.
I do not like ice cream.	Man nepatīk saldējums.
This is my computer.	Tas ir mans dators.
I've got nothing to hide.	Man nav nekas slēpjams.
I've seen you before.	Es esmu jūs kaut kur redzējis.
I just want a normal life.	Es tikai vēlos normālu dzīvi.
I know how much money Tom has.	Es zinu cik naudas Tomam ir.
I know what Tom likes.	Es zinu kas Tomam patīk.
I need to feed my dog.	Man ir jāpabaro mans suns.
I no longer live in Boston.	Es vairs nedzīvoju Bostonā.
I really like you a lot.	Tu man patiešām ļoti patīc.
An expert is a person who has made all the mistakes that can be made in a very narrow field.	Eksperts ir persona, kura ir pieļāvusi visas kļūdas, kuras vien var pieļaut, kādā ļoti šaurā jomā.
We all need to stay together.	Mums visiem jāpaliek kopā.
We didn't do a thing.	Mēs neko nedarījām.
We don't even need this.	Mums pat to nevajag.
We don't have any proof.	Mums nav nekādu pierādījumu.
We don't want to take anything.	Mēs neko nevēlamies ņemt.
We often talk about the weather.	Mēs bieži runājam par laika apstākļiem.
What could it be?	Kas tas varētu būt?
What're we waiting for?	Ko mēs gaidām?
What're you looking for?	Ko tu meklē?
Whatever you do, don't pull this rope.	Lai ko tu darītu, nevelc šo virvi!
I have two cats.	Man ir divi kaķi.
I see a white lion.	Es redzu baltu lauvu.
I don't want to work under these conditions.	Es negribu strādāt šādos apstākļos.
I can't answer this question.	Es nevaru atbildēt uz šo jautājumu.
I think you're mistaken.	Es domāju, ka tu kļūdies.
Books are the bees that carry pollen from one mind to another.	Grāmatas ir kā bites, kas nes putekšņus no viena prāta uz otru.
Tom is my second cousin.	Toms ir mans otrais brālēns.
The two boys are cousins.	Šie zēni ir brālēni.
The cows are milked at six.	Govis tiek slauktas sešos.
Mary is my cousin.	Marija ir mana māsīca.
We wondered what would happen after Tom showed up.	Mēs prātoju, kas notiktu pēc tam, kad Toms atnāktu.
Nothing much is happening yet.	Nekas nav noticis pagaidām.
I clicked the link, but nothing happened.	Es klikšķināju uz mājaslapas, bet nekas nenotika.
Tom is a bit older than Mary.	Toms ir mazliet vecāks par Mariju
There is a secret base on the other side of the moon.	Uz otrās mēness puses ir slepena bāze.
Welcome to Wikipedia, the free encyclopedia that anyone can edit.	Laipni lūdzam Vikipēdijā, brīvajā enciklopēdijā, kuru var papildināt jebkurš.
I can get anything I want.	Es varu dabūt visu ko es gribu.
Tom promised to give me anything I wanted.	Toms man apsolīja dot visu ko es gribu.
So there is a problem...	Tā ir problēma.
But there's a problem.	Bet ir problēma.
I see you had your homework ready before dinner.	Es redz, ka tavs mājas darbs ir gatavs pirms vakariņām.
We have to stop him from drinking more alcohol.	Mums ir jāaptur viņu no dzeršanas vairāk alkohola.
When she saw me, she was embarrassed.	Kad viņa ieraudzīja mani, viņa bija neērti.
We're only friends?	Mēs esam tikai draugi?
We're just friends?	Mēs esam tikai draugi?
Are we only friends?	Vai mēs esam tikai draugi?
He is really a good worker.	Viņš tiešām ir labs darbā.
Mr. John's older than I thought.	Misters Jons ir vecāks nekā es domāju.
The train arrived ten minutes late.	Vilciens atbrauca desmit minūtes vēlāk.
Tom speaks Japanese better than Japanese do.	Toms runā Japāņu valoda labāk nekā Japāņi.
That bed is very comfortable.	Tā gulta ir ļoti ērta.
I will write a letter.	Es uzrakstīšu vēstuli.
My younger brother is yelling loudly.	Mans jaunākais brālis kliedz skaļi.
He only screams when he's hungry.	Viņš tikai kliedz kad ir izsalcis.
Give me the report on Monday.	Atdodiet man ziņojumu Pirmdien.
He's doing well.	Viņš klājas labi.
These horses are yours.	Šie zirgi ir jūsu.
These horses are his.	Šie zirgi ir viņa.
He worked the whole night.	Viņš strādāja visu nakti.
People should love each other.	Cilvēkiem vajadzētu mīlēt citam citu.
I take the bus to work every day.	Es ar autobusu uz darbu dodos katru dienu.
I am fat.	Es esmu resns.
Your daughters are beautiful.	Tava meita ir skaista.
My memory is slow.	Mana atmiņa ir lēna.
He wishes he had glorious hair.	Viņš vēlētos lai viņam būtu krāšņi mati.
That's the only way to do it.	Ir tikai viens veids, kā to izdarīt.
Who's hungry?	Kāds ir izsalcis?
Our yard is large.	Mūsu pagalms ir liels.
Your pen is bad.	Tava pildspalva ir slikta.
I can teach you if you want.	Es varu jūs iemācīt, ja jūs to gribat.
Who is hungry?	Kurš ir izsalcis?
You should write a book!	Tev vajadzētu uzrakstīt grāmatu!
This is going too far.	Tas ir aizgājis par tālu.
I like extracted juice.	Man patīk izspiesta sula.
Where's that?	Kur ir tas?
He's drunk.	Viņš ir piedzēries.
Tom is sure.	Toms ir pārliecināts.
It really happened.	Es patiešām esmu laimīgs.
I long for you.	Es ilgojos pēc tevis.
He drew an apple.	Viņš uzzīmēja ābolu.
Please give me this money.	Lūdz iedod man šo naudu.
Our army staged a night raid against the enemy.	Mūsu armija iestudētas nakts reids pret ienaidnieku.
Don't confuse Chinese with Japanese.	Nejauciet Ķīniešus ar Japāņiem.
I call the boy and he comes.	Es pasaucu zēnu un viņš atnāca.
It seems he knows Ann.	Izskatās, ka viņš pazīst Annu
If you visit Tom right now, he's probably just watching TV.	Ja tu tagad apciemosi Tomu, viņš drošvien skatīsies TV
We're going downtown to go shopping.	Mēs ejam uz centru iepirkties.
She gets paid a lot.	Viņai maksā daudz.
Tom pushed the button, but nothing happened.	Toms piespieda pogu, bet nekas nenotika.
I'm sorry. I didn't do it on purpose.	Man žēl. Es to negribēju darīt ar nolūku.
We were surprised by that news.	Mēs bijām pārsteigti par šo ziņu.
You have bad breath.	Tev ir slikta elpa.
I didn't like my name when I was young.	Man nepatika mans vārds, kad es biju jauns.
You are right.	Tev ir taisnība.
She is busy. Wait a minute.	Viņa ir aizņemta. Uzgaidi minūti!
We want to take your blood pressure.	Mēs vēlamies pārbaudīt jūsu asinsspiedienu.
Look at that red car.	Paskaties uz to sarkano mašīnu.
A mare is a female horse.	Ķēve ir zirgu sieviete.
Is this a stallion or a mare?	Vai šis ērzelis vai ķēve?
I'm sure you can do even better.	Esmu pārliecināts ka tu to vari izdarīt vel labāk.
Tom drove to the supermarket.	Toms piebrauca pie lielveikala.
I'm sorry you feel that way.	Man ir žēl ka tu jūties tā.
Tom is asleep on the bench.	Toms ir aizmidzis uz soliņa.
I'm having a heart attack.	Man ir sirdstrieka.
You've come just in time.	Jūs atnācāt tieši laikā.
I'm tired of losing.	Es esmu noguris no zaudēšanas.
It's almost noon.	Ir gandrīz pusdienlaiks.
Fibre-optic cables can carry huge amounts of information.	Optisko šķiedru kabeļi var caurlaist milzīgu daudzumu informācijas.
My uncle lives next to the school.	Mans onkulis dzīvo blakus skolai.
His great performance drew thundering applause from the audience.	Viņa lieliskā uzstāšanās publikā izraisīja vētrainus aplausus.
They picked out the best two works.	Viņi izvēlējās divus labākos darbus.
He plays piano.	Viņš prot spēlēt klavieres.
You don't seem too happy to see me.	Tu neizskaties priecīgs mani redzot.
That attitude of his is quite disgusting.	Šī viņa attieksme ir diezgan riebīga.
Alcohol doesn't solve any problems.	Alkohols neatrisina kādas problēmas.
By the way, have you heard about Suzuki?	Starp citu, vai tu jau dzirdēji par Suzuki?
He has issues.	Viņam ir jautājumi.
Go and say goodbye to him before he leaves.	Ej un atvadies no viņa pirms viņš aiziet.
Tom needed your help.	Tomam vajag tavu palīdzību.
Do you have a house?	Vai tev ir māja?
I'd like to live in Europe.	Man patīk dzīvot Eiropā.
My watch has stopped.	Mans pulkstenis ir apstājies.
I live in a city.	Es dzīvoju pilsētā.
I'll live in the city.	Es dzīvošu pilsētā.
He kept writing about animals.	Viņš turpina rakstīt par dzīvniekiem.
I worked in this factory.	Es strādāju šajā rūpnīcā.
Angela is not an angel.	Anžela nav eņģelis.
I'm swimming in the ocean.	Es peldu okeānā.
Do we have time?	Vai mums ir laiks?
I live in Baku.	Es dzīvoju Bakū.
She was an enchantress.	Viņa bija burve.
He died in battle.	Viņš mira cīņā.
What's happening in Italy?	Kas notiek Itālijā?
Life is a gift.	Dzīve ir dāvana.
I live in Chile.	Es dzīvoju Čīlē.
I live in Colombia.	Es dzīvoju Kolumbijā.
I live in Peru.	Es dzīvoju Perū.
Brazil is the biggest country in South America.	Brazīlija ir lielākā valsts Dienvidamerikā.
I live in Riga.	Es dzīvoju Rīgā.
I live in Latvia.	Es dzīvoju Latvijā.
I'll live in Cambodia.	Es dzīvošu Kambodžā.
I want to be a linguist.	Es gribu kļūt par valodnieku.
I'm eating bread.	Es ēdu maizi.
I'm in the post office.	Es esmu pasta nodaļā.
I drink water.	Es dzeru ūdeni.
I speak Latvian.	Es runāju latviski.
Everything went back in place.	Viss nostājās savā vietā.
Doctor, I've got an itch in my crotch.	Dakter, man niez kājstarpe.
I can't believe he left me for that whore!	Es nespēju noticēt, ka tu mani pameti dēļ tās maukas!
All animals are equal.	Visi dzīvnieki ir vienādi.
You fucked up my life.	Tu sadirsi manu dzīvi.
Melanie is eating an apple.	Melānija ēd ābolu.
How long have you been living in Italy?	Cik ilgi jūs dzīvojat Itālijā?
I borrow books from the city library.	Es aizņemos grāmatas no pilsētas bibliotēkas.
Africa is the cradle of humanity.	Cilvēces šūpulis ir Āfrika.
I thought he was coming.	Es domāju, ka viņš atnāks.
Tom traveled around Europe.	Toms ceļoja apkārt Eiropai.
"Dear, where have you been?" "I've been running." "But your T-shirt is dry and doesn't smell at all."	"Dārgum, kur tu biji?" -"Es biju skriet." -"Bet tavs T-krekls ir sauss un nemaz nesmird."
He has plans.	Viņam ir plāni.
There is a girl in this room.	Istabā pastāv meitene.
There is a cat in this room.	Istabā pastāv kaķis.
There are two girls in the playground.	Rotaļlaukumā pastāv divas meitenes.
You speak English.	Tu runā angliski.
Who are all these people?	Kas ir visi šie cilvēki?
A dog ran away.	Suns aizbēga
You smile.	Tu smaidi.
I haven't read this book.	Neesmu šo grāmatu lasījis.
He gave me friendly advice.	Viņš iedeva man draudzīgu padomu.
What do you think of me?	Ko tu domā par mani?
What do you think of our collection?	Ko tu domā par mūsu kolekciu?
I'm an archaeologist.	Es esmu arheologs.
I teach geography.	Es mācu ģeogrāfiju.
The geophysicist teaches in the school.	Ģeofiziķis māca skolā.
I don't live in this city.	Es nedzīvoju šajā pilsētā.
He said something.	Viņš kaut ko teica.
She said something.	Viņa kaut ko teica.
She's two years younger than me.	Viņa ir divus gadus jaunāka par mani.
You have been playing.	Tu biji spēlējis.
You had been playing.	Tu spēlēji.
Fear your own shadow.	Baidies pats savas ēnas.
I want to say "goodbye" and "thanks" in Esperanto. Can you help me?	Es vēlos pateikt ''uz redzēšanos'' un ''paldies'' Esperanto valodā. Vai vari man palīdzēt?
He's moved away.	Viņš aizvācās prom.
Today I'm paying!	Šodien es spēlēju!
Today I'm crying!	Šodien es raudu!
I like them both.	Man patīk viņi abi.
We should protect the forest.	Mums vajadzētu aizsargāt mežu.
He didn't even read it.	Viņš pat to neizlasīja
His carpet is completely white.	Viņa paklājs ir pilnībā balts.
Yokhen is my good friend.	Jokains ir man labs draugs.
They asked Mary to look after the children.	Viņi palūdza Marijai pieskatīt bērnus.
I bought milk today.	Es šodien nopirku pienu.
I did tell you to stay in the car.	Es tev pateicu lai tu paliec mašīnā.
I hope to meet this man.	Es ceru satikt šo vīru.
Why on earth are you still angry at me?	Kāpēc tu uz mani aizvien dusmojies?
Who loves the son?	Kas mīl dēlu?
He loves the son.	Viņš mīl dēlu.
We don't have a daughter.	Mums nav meita.
I haven't got books.	Man nav grāmatas.
Today's not Christmas!	Šodien nav Ziemassvētki!
He likes music.	Viņam patīk mūzika.
Can you follow me?	Vai tu vari mani sekot?
The boy is not tall.	Zēns nav garš.
The song, which changed her life, is being sung at every one of her performances.	Dziesma, kas mainīja viņu dzīvi, joprojām jādzied katrā uzstāšanās reizē.
It's just to remind and put it on paper.	Vienkārši jāatsauc atmiņā un jāliek uz papīra.
Speaking of Switzerland, have you ever been there in winter?	Runājot par Šveici, vai tu tur esi kādreiz bijis ziemā?
Tom gave me that book.	Toms man iedeva to grāmatu.
Where is Poland?	Kur ir Polija?
My son has a son.	Manam dēlam ir dēls.
I knew that he lies.	Es zināju, ka viņš melo.
This is the beginning of a new era.	Šis ir jaunas ēras sākums.
He really wants to work as a translator.	Viņš tiešām grib strādāt par tulkotāju.
He is too slow.	Viņš ir pārāk lēns.
They're reading a book.	Viņi lasa grāmatu.
You're cooking now.	Tu tagad gatavo.
I'm eating a sandwich.	Es ēdu sviestmaizi.
The milk is sour.	Piens ir skābs.
You can always talk to me.	Tu vienmēr vari runāt ar mani.
Why are you still talking?	Kāpēc tu joprojām runā?
What should we talk about?	Ko mums vajadzētu parrunāt?
We're talking to you, Tom.	Mēs runājam ar jums, Tomi.
I want to live in Brazil.	Es gribu dzīvot Brazīlijā.
The island was completely deserted.	Sala bija pilnībā pamesta.
I'm Ricardo.	Es esmu Ricardo.
Tom attacked Mary.	Toms uzbruka Marijai.
Could you translate this sentence into English?	Vai tu varētu iztulkot šo teikumu angliski?
Maybe it wasn't so obvious.	Varbūt tas nebija tik acīmredzami.
Do you have another plan?	Vai tev ir cits plāns?
Now that I'm thinner, I can fit into this dress.	Tagad, kad esmu tievāka, es varu uzvilkt šo kleitu.
Your son is sick.	Jūsu dēls ir slims.
Tom put pressure on me.	Toms izdarīja uz mani spiedienu.
All of us are getting older.	Mēs visi kļūstam vecāki.
The referee showed him the yellow card.	Tiesnesis parādīja viņam dzelteno kartiņu.
He was nicknamed "The Potato King."	Viņam bija iesauka "Kartupeļu karalis".
Europeans are the largest consumers of alcohol in the world.	Eiropieši ir lielākie alkohola patērētāji pasaulē.
Europeans are the world's largest consumers of alcohol.	Eiropieši ir pasaulē lielākie alkohola patērētāji.
Europeans drink, on average, 12.5 liters of pure alcohol per year.	Eiropieši gadā izdzer vidēji 12,5 litrus tīra alkohola.
I rarely talk on the phone.	Es reti runāju pa telefonu.
Do me a favour; just stop being so fucking dumb for a minute.	Izdari man pakalpojumu un pārstāj būt tik sasodīti stulbs uz kādu brīdi.
You had dealings with a crook.	Tev bija darīšanas ar blēdi.
What did Tom get you for your birthday?	Ko Toms uzdāvināja tev dzimšanas dienā?
That hat looks good on Tom.	Tā cepure Tomam piestāv.
Did somebody hit Tom?	Vai Tomam kāds iesita?
I think Tom was the one who stole my wallet.	Man šķiet, ka Toms bija tas, kurš nozaga manu maku.
What if Tom is wrong?	Ja nu Tomam nav taisnība?
Do you speak like the Italians?	Vai tu runā kā itāļi?
Would you shut up?	Vai tu neaizvērtos?
They're a couple.	Viņi ir pāris.
It's a conspiracy.	Tā ir sazvērstība.
It's a compliment.	Tas ir kompliments.
Tom has an eclectic taste in music.	Tomam ir eklektiska mūzikas gaume.
Do you have anything else?	Vai tev ir kaut kas cits?
Everybody please calm down.	Nomierinieties visi, lūdzu.
The German soccer team beat Brazil convincingly.	Vācu futbola komanda pārspēja brazīliešus pārliecinoši.
I can't believe I actually wanted to marry you.	Es nespēju noticēt, ka patiešām gribēju precēties ar tevi.
Do you think I haven't anticipated that?	Tu domā ka es to negaidiju.
You deserved that.	Tu to biji pelnījis.
Tom isn't like other boys.	Toms nav tāds kā citi puiši.
Who's Tom looking for?	Ko Toms meklē?
Mankind must put an end to war, or otherwise war will put an end to mankind.	Cilvēcei vajaga pielikt punktu karam savādāk karš pieliks punktu cilvēcei.
You asked for our help.	Tu lūdzi mūsu palīdzību.
Why should they hide?	Kāpēc viņiem būtu jāslēpjas?
Nobody wants to drink?	Neviens negrib dzert?
This is Tom's cat.	Šis ir Toma kaķis.
I'm trying very hard not to cry.	Es ļoti cenšos neraudāt.
There are islands in the sea.	Salas ir jūrā.
I will never forget this day.	Es nekad neaizmirsīšu šo dienu.
Be careful: We capitalize nationalities, days of the week, and languages in English.	Uzmanies: Angļu valodā mēs nacionalitātes, nedēļas dienas un valodas rakstām ar lielo burtu.
I hope that I can do it.	Es ceru, ka varu to izdarīt.
I have a horse.	Man ir zirgs.
How did you know Tom was going to die?	Kā tu zināji ka Toms nomirs?
Are you going to eat that piece of pie?	Vai tu ēdīsi to pīrāga gabalu?
Tom just didn't like it.	Tomam tas nepatika.
Tell me what you find out.	Pastāsti man ko esi atklājis.
I am a widow.	Es esmu atraitne.
Women change the world.	Sievietes maina pasauli.
Persian is not a difficult language.	Persiešu valoda nav grūta valoda.
The average human body contains enough bones to make an entire human skeleton.	Vidējais cilvēka ķermenis satur pietiekošu daudzumu kaulu, lai izveidotu veselu skeletu.
I knew what they did to him.	Es zinu ko viņi viņam izdarīja.
I knew what they did to her.	Es zinu ko viņi viņai izdarīja.
Do you love your mother?	Vai jums patīk jūsu māti?
Did you see where Tom went?	Vai tu redzēji kur palika Toms?
We don't know where Tom went.	Mēs nezinam kur Toms palika.
Please take me to the airport.	Lūdzu aizvediet mani uz lidostu.
October was worse.	Oktobris bija slikts.
Now, that's funny.	Lūk, tas bija smieklīgi.
I didn't have to go, but I did.	Mi ne devis iri, se mi ja iris.
Everyone else does it.	Visi citi to dara.
Will you come?	Vai tu atnāksi?
I don't live in Boston anymore.	Es vairs nedzīvoju Bostonā.
I am sorry, but what's your name again?	Piedodiet, bet kāds bija jūsu vārds?
Everything seems to be just fine.	Liekas ka viss ir kārtība.
Sorry for frightening you.	Piedod ka nobiedēju.
You did it on purpose!	Tu to izdariji tīšām!
To be honest, I don't understand it.	Godīgi sakot, es to nesaprotu.
"How long will you remain in New York?" "Until Saturday."	''Cik ilgi tu paliksi Ņujorkā?'' ''Līdz sestdienai.''
"How long will you remain in Moscow?" "Until Sunday."	''Cik ilgi tu paliksi Maskavā?'' ''Līdz sestdienai.''
"How long will you remain in London?" "Until Monday."	''Cik ilgi tu paliksi Londonā?'' '' Līdz pirmdienai.''
Tom gained American citizenship.	Toms ieguva Amerikas pilsonību.
The skeptics were right.	Skeptiķiem bija taisnība.
His mother works as a librarian at a private school.	Viņa māte strādā privātskolā par bibliotekāri.
Why aren't you at work?	Kāpēc tu neesi darbā?
Tom is a martial arts expert.	Toms ir cīņas mākslu eksperts.
She is my muse.	Viņa ir mana mūza.
Tom can play nearly as well as Mary.	Toms spēlē gandrīz tikpat labi kā Marija
I asked first.	Es pirmais jautāju.
I asked you first.	Es tev pirmais jautāju.
I don't know how I did that.	Es nezinu kā es to izdarīju.
I don't know how I did it.	Es nezinu kā es to izdarīju.
I'm really glad you came.	Esmu ļoti priecīgs, ka tu atnāci.
I hope we'll meet again.	Es ceru, ka mēs tiksimies vēlreiz.
I knew Tom meant no harm.	Es zinu, ka Toms nedomāja ļaunu.
I go there all the time.	Es tur eju visu laiku.
I advised Tom to go home.	Es ieteicu Tomam doties mājās.
I don't want to eat now.	Es tagad negribu ēst.
I was happy I did that.	Es biju priecīgs, ka to izdarīju.
What did Tom talk about?	Par ko Toms runāja?
I never had much money.	Man nekad nav bijis daudz naudas.
I hope that it'll work.	Es ceru, ka tas strādās.
I don't have any plans.	Man nav nekādu plānu.
I can't help you today.	Es tev šodien nevaru palīdzēt.
I'm sure I'll do that.	Esmu pārliecināts, ka es to izdarīšu.
It's time for Tom to go.	Tomam ir laiks doties.
I'd like to know more.	Es gribētu uzzināt vairāk.
I've seen Tom in action.	Es esmu redzējis Tomu darbībā.
I didn't want to lose.	Es negribēju zaudēt.
I'll never make it in time.	Es nekad neuzspēšu laikā.
I don't care what it costs.	Man vienalga, cik tas maksā.
I thought I put it right there.	Man likās, ka es to noliku tur.
It's a stupid system.	Tā ir stulba sistēma.
Tom cut the wrong wire.	Toms pārgrieza nepareizo vadu.
Tom cut the wire and defused the bomb.	Toms pārgrieza vadu un atmīnēja bumbu.
Tom plays the guitar almost as well as Mary does.	Toms spēlē ģitāru gandrīz tikpat labi kā Marija.
Tom plays the guitar almost as well as Mary.	Toms spēlē ģitāru gandrīz tikpat labi kā Marija.
I thought that I put it right there.	Man likās, ka es to noliku tur.
The clock is not working.	Pulkstenis neiet.
Turtles don't have teeth.	Bruņurupučiem nav zobu.
I have no horse.	Man nav zirga.
I don't have a horse.	Man nav zirga.
Space has no "up" or "down."	Visumam nav ''augšas'' vai ''apakšas''.
Astronauts are weightless and can sleep in any orientation. However, they have to attach themselves so they don't float around and bump into something.	Astronautiem nav svara un var gulēt jebkādā pozīcijā. Bet, viņiem ir sevi jāpiesprādzē lai viņi nelidinātos apkārt un nekam neuztriektos.
Space station crews usually sleep in sleeping bags located in small crew cabins.	Kosmosa stacijas komanda parasti guļ guļammaisos kuri atrodas mazas kabines.
Your husband is cheating on you.	Tavs vīrs tevi krāpj.
Watch out for pickpockets.	Uzmanies no zagļiem.
Do you drink rum and Coke?	Vai tu dzer rumu un kolu?
Ladies also play with the ball.	Dāmas arī spēlē bumbu.
You're an artist, aren't you?	Tu esi mākslinieks, vai ne?
We're still nervous.	Mēs vēl esam nervozi.
Everyone's waiting to see what's going to happen.	Visi gaida, lai redzētu, kas notiks.
Tom is a visual thinker.	Toms ir vizuāls domātājs.
People die, but the things they create endure.	Cilvēki mirst, bet liekas, kuras viņi rada, paliek.
I am not at all young anymore.	Es nepavisam vairs neesmu jauns.
At what age do children leave school?	Kādā vecumā bērni beidz skolu?
John goes to school.	Džons iet uz skolu.
I'm afraid I can't tell you this.	Baidos, ka nevaru tev to stāstīt.
It's your color!	Tā ir tava krāsa!
I love to take pictures.	Man patīk fotogrāfēt.
When I was small I was one of the few boys on the street who didn't like football.	Kad es biju mazs, es biju viens no retajiem ielas zēniem, kam nepatika futbols.
He has a mysterious talisman in the form of an eye.	Viņam ir mistisks talismans acs formā.
It's a truly difficult problem to fix.	Tā ir tiešām grūti novēršama problēma.
The kids are visitors.	Bērni ir viesi.
The question is if my parents approve of it or not.	Jautājums ir, vai mani vecāki to akceptē vai nē.
Here anything can happen.	Šeit jebkas var notikt.
What's the title of your new book?	Kāds ir Tavas jaunās grāmatas nosaukums?
I don't know the cause.	Es nezinu iemeslu.
Today he feels much better than yesterday.	Šodien viņš jūtas daudz labāk kā vakar.
They're lucky.	Viņiem veicas.
Why do you care what other people think?	Kāpēc tu uztraucies ko cilvēki domā?
I need to know everything.	Man jāzin viss.
I'm not going to die today.	Es netaisos mirt šodien.
Hand me that phone.	Paspiedz man to telefonu.
Dance like no one is watching.	Dejo itkā neviens neskatītos.
She wants to wait until marriage.	Viņa grib gaidīt līdz kāzām.
I knew this was a dream!	Es zināju, ka tas bija sapnis!
Is your brother's name Tom?	Vai tava brāļa vārds ir Toms?
Tom really likes chocolate cake.	Tomam ļoti garšo šokolādes kūka.
I'm not excited about it.	Es neesmu par to sajūsmā.
My father is watering the flowers.	Mans tēvs laista puķes.
Tom forgot to lock the house's door.	Toms aizmirsa aizslēgt mājas durvis.
The cops won't find you there.	Policisti neatradīs tevi šeit.
The news isn't good.	Ziņas nav labas.
Tom has no friends here.	Tomam šeit nav draugu.
We're trying to win.	Mēs mēģinam uzvarēt.
How could you be so certain?	Kā tu vari būt tik drošs?
We'll certainly invite Tom.	Mēs noteikti ielūgsim Tomu.
I feel the need to do something different today.	Es jūtu vajadzību darīt kautko citu šodien.
A long time ago, giants ruled the world.	Sen atpakaļ milži valdīja pār pasauli.
I didn't quite know what to say.	Es īsti nezināju, ko teikt.
We also did amputations. We had to do them.	Mēs arī veicām amputācijas. Mums tas bija jādara.
Language is a system of signs.	Valoda ir zīmju sistēma.
Language is a living organism.	Valoda ir dzīvs organisms.
Latin is an Indo-European language.	Latīņu valoda ir indo-eiropiešu valoda.
They aren't like us.	Viņi nav tādi kā mēs.
I don't care either way.	Man vienalga jebkurā gadījumā.
Are you saying that Tom is a traitor?	Vai tu saki, ka Toms ir nodevējs?
Stop playing with your hair.	Beidz spēlēties ar saviem matiem.
Tom works in a coffee shop.	Toms strādā kafejnīcā.
They're going to find your stash of cigarettes, and then you'll be in trouble.	Viņi atradīs tavus cigarešu krājumus, un tad tev būs problēmas.
They'll find your cigarette cache, and then you'll have problems.	Viņi atradīs tavu cigarešu krātuvi, un tad tev būs problēmas.
I think that Tom is dangerous.	Es domāju, ka Toms ir bīstams.
Tom has to do that before Monday.	Tomam tas ir jāizdara līz pirmdienai.
Tom has three gorgeous daughters.	Tomam ir trīs skaistas meitas.
You need to get your hair cut.	Tev vajag nogriezt matus.
Sleep!	Guli!
How important?	Cik svarīgi?
Discover the world!	Atklāj pasauli!
Never stop dreaming!	Nekad nepārstāj sapņot!
I'm going to miss that somewhat.	Man tas mazliet pietrūks.
I still think of Tom.	Es aizvien domāju par Tomu.
I can help if you'd like.	Es varu palīdzēt ja tu gribi.
I'm a romantic.	Es esmu romantiķis.
I didn't know what that meant.	Es nezinu ko tas nozīmē.
I'm already a father.	Es jau esmu tēvs.
How often do you use your telephone?	Cik bieži tu izmanto savu telefonu?
I'm a believer.	Es esmu ticīgais.
Do you know the bus driver?	Vai tu pazīsti autobusa vadītāju?
I wonder how much you know about this.	Es domāju cik daudz tu zini par šo.
I don't think Tom would've done that.	Es domāju ka Toms to nebūtu darijis.
I didn't know what to believe.	Es nezinu kam ticēt.
I'll let you do that.	Es tev atļauju to darīt.
How often should you wash your hair?	Cik bieži vajadzētu mazgāt matus.
I write poetry.	Es rakstu poēmu.
Do you ever wear a bow tie?	Vai tu kādreiz velc tauriņu?
I'll be out of town until next Monday.	Es būšū izbraucis līdz nākošajai pirmdienai.
I can't believe Tom really said that.	Es nespēju noticēt ka Toms to pateica.
I didn't want to shoot my dog.	Es nevēlos nošaut savu suni.
I won't sing tonight.	Es šonakt nedziedāšu.
I work indoors.	Es strādāju iekštelpās.
You must be really hungry.	Tu noteikti esi ļoti izsalcis.
I'm getting tired of your complaining.	Es sāku nogurt no taviem parmetumiem.
Tom wasn't the one who told me that.	Toms nebija tas kurš to man pateica.
I don't have to do that today.	Man to šodien nevajaga darīt.
I won't eat anything.	Es neēdīšu neko.
How well do you know your neighbors?	Cik labi tu pazīst savus kaimiņus?
I wore a hoody.	Es valkāju kapuci.
Why do we have to go home?	Kāpec mums vajaga iet mājās?
I'm too old to do something like that.	Es esmu par vecu lai darītu kautko tādu.
Tom wasn't the one who gave me that.	Toms nebija tas kurš man to iedeva.
I don't like punk rock at all.	Man nemazs nepatīk roks.
I wish I were famous.	Es vēlos kaut es būtu slavens.
How will we get this done by Monday?	Kā mēs paspēsim to izdarīt līdz pirmdienai?
I won't starve.	Es nenomiršu badā.
I've already seen that movie, I think.	Es domāju ka es esmu jau redzējis to filmu.
Tom was never very friendly to Mary.	Toms nekad nebija draudzīgs pret Mariju.
I went out by myself.	Es izgāju viens pacs.
How will we overcome these problems?	Kā mēs parvarēsim šo problēmu?
I won't eat it.	Es to neēdīšu.
What's your cousin's name?	Kads ir tava brālēna vārds?
I don't want to die in prison.	Es nevēlos mirt cietumā.
I wasn't too worried.	Es nebiju parāk uztraucies.
How worried should we be about that?	Cik noraizējušiem mums vajadzētu būt par to?
What do you want for that?	Ko tu vēlies par to?
I've probably already seen that movie.	Es drošivien esmu jau redzējis to filmu.
I had intended to go shopping.	Es biju domājis doties iepirkties.
How would you handle this situation?	Kā tu tiktu galā ar šo situāciju?
I went outside.	Es izgāju ārā.
What do you suppose it is?	Kā tu domā kas tas ir?
I had to wait for a long time.	Man vajadzēja gaidīt ilgu laiku.
How would your friends describe you?	Kā tavi draugi tevi aprakstītu?
I wasn't fired.	Mani neatlaida.
Lectures take place frequently.	Lekcijas notiek bieži.
In summer it often rained.	Vasarā bieži lija.
The weather was warm but rainy.	Laiks bija silts, bet lietains.
The father is there.	Tēvs ir tur.
The fathers are there.	Tēvi ir tur.
The horse is in the forest.	Zirgs ir mežā.
You have a horse.	Tev ir zirgs.
I help the father.	Es palīdzu tēvam.
Father is here.	Tēvs ir šeit.
Father is not here.	Tēva šeit nav.
I can't go to work today because I have the flu.	Es nevaru šodien iet uz darbu, jo man ir gripa.
Octopuses have three hearts.	Astoņkājiem ir trīs sirdis.
It's open source software.	Tā ir atvērtā koda programmatūra.
The Russians are on our side.	Krievi ir mūsu pusē.
The last time I saw Tom he was barefoot.	Pēdējo reizi, kad es redzēju Tomu, viņš bija basām kājām.
Tom and Mary had to borrow money from John to pay their rent.	Tomam un Marijai bija jāaizņemās nauda no Džona, lai samaksātu īri.
Should I turn left, right, or go straight?	Vai man vajadzētu nogriezties pa kreisi, pa labi, jeb doties taisni?
Please don't talk about Russian potato salad! I'm so hungry.	Lūdzu nerunājiet par Krievu kartupeļu salātiem! Esmu ļoti izsalcis.
Mary had a flu.	Marijai bija gripa.
A young and charming gentleman offered me a candy.	Jauns un šarmants džentlmenis piedāvāja man konfekti.
This story is old as the world.	Šis stāsts ir vecs kā pasaule.
It was the good old days.	Tās bija vecās labās dienas.
Tom has never been young.	Toms nekad nav bijis jauns.
Tom had the most absurd ideas.	Tomam bija pašas absurdākās idejas.
Last week we worked day and night.	Pagājušo nedēļu mēs strādājām dienu un nakti.
Where do your ancestors come from?	No kurienes ir nākuši tavi senči?
Tom can always wait!	Toms var vienmēr pagaidīt!
You must eat breakfast before you go to school.	Pirms tu dodies uz skolu tev ir jāapēd brokastis.
Why do sentences in Japanese look so weird?	Kāpēc teikumi Japāņu valodā izskatās tik dīvaini?
Do you see the girl wearing black silk dress? It's my daughter.	Vai tu redzi meiteni melnajā zīda kleitā? Tā ir mana meita.
Tom wore a straw hat.	Toms valkāja salmu cepuri.
For sure.	Noteikti.
I'm going to strangle him.	Es viņu nožņaugšu.
"Where's Tom?" "I don't know. He was here a few moments ago."	"Kur ir Toms?" "Es nezinu. Viņš kādu brīdi atpakaļ te vēl bija."
"Where's Tom?" "I don't know. He was here a few minutes ago."	"Kur ir Toms?" "Es nezinu. Viņš pirms dažām minūtēm vēl te bija."
I can only stay a few minutes.	Es varu palikt tikai uz dažām minūtēm.
I'll tell you everything from the beginning.	Es tev izstāstīšu visu no paša sākuma.
Tom has a good excuse.	Tomam ir labs attaisnojums.
Tom also teaches geography and history.	Toms arī pasniedz ģeogrāfiju un vēsturi.
I've never hurt Tom.	Es nekad neesmu sāpinājis Tomu.
I hope we find it.	Es ceru, ka mēs to atradīsim.
I need to find it.	Man vajag to atrast.
Tom won't find me.	Toms mani neatradīs.
I prefer comedies.	Es dodu priekšroku komēdijām.
Tom won't find us.	Toms mūs neatradīs.
Shouldn't we help?	Vai mums nevajadzētu palīdzēt?
Tom won't help me.	Toms man nepalīdzēs.
The pizza is here.	Pica ir klāt.
Tom won't stop me.	Toms mani neapturēs.
Tom's dog is dead.	Toma suns ir miris.
Here are your bags.	Šeit ir jūsu somas.
When will Tom eat?	Kad Toms ēdīs?
I don't have a cow.	Man nav govs.
Will Tom help you?	Vai Toms tev palīdzēs?
I found a good job.	Es atradu labu darbu.
Will you kiss Tom?	Vai tu noskūptīsi Tomu?
Will you warn Tom?	Vai tu brīdināsi Tomu?
I haven't paid yet.	Es vēl neesmu samaksājis.
I just sold my car.	Es tikko pārdevu savu mašīnu.
I live near a park.	Es dzīvoju netālu no parka.
I left Tom at home.	Es atstāju Tomu mājās.
I need a corkscrew.	Man vajag korķviļķi.
I never drink beer.	Es nekad nedzeru alu.
Tom is a horn dog.	Toms ir ērzelis.
Tom is a cassanova.	Toms ir kazanova.
Tom and Mary slept under the stars.	Toms un Marija gulēja zem zvaigžņotām debesīm.
Tom refused to play with the guinea pigs.	Toms atteicās spēlēties ar jūrascūciņām.
Tom can't fire Mary.	Toms nevar atlaist Mariju.
Where will I sleep?	Kur es gulēšu?
Tom let Mary escape.	Toms ļāva Marijai aizmukt.
Are these your skis?	Šīs ir tavas slēpes?
Tom often says that.	Toms bieži to saka.
I don't have a list.	Man nav saraksta.
Where's Tom's watch?	Kur ir Toma pulkstenis?
I don't like flying.	Man nepatīk lidot.
She came along.	Viņa atnāca līdzi.
James sold his car.	Džeimss pārdeva savu mašīnu.
He broke his leg.	Viņš salauza kāju.
He was rich.	Viņš bija bagāts.
There is a restaurant near here.	Te netālu ir restorāns.
My husband gave me a red car.	Mans vīrs man iedeva sarkanu mašīnu.
I will buy a big house.	Es nopirkšu lielu māju.
We ran back and forth, carrying buckets of water.	Mēs skrējām uz priekšu un atpakaļ, nesot spaiņus ar ūdeni.
Employees were always complaining about their wages, their working conditions, and so forth.	Darbinieki vienmēr ir sūdzējušies par viņu algām, viņu darba apstākļiem, un tā tālāk.
Do you like cycling?	Vai tev patīk riteņbraukšana?
Does Tom have an iPad?	Vai Tomam ir iPad?
I painted the house.	Es nokrāsoju māju.
I know Tom lied to us.	Es zinu, ka Toms mums sameloja.
Please give me that.	Lūdzu iedod man to.
Sami's daughter is Farid's wife.	Semī meita ir Farīda sieva.
They should ask Tom first.	Viņiem vispirms vajadzētu pajautāt Tomam.
Good evening, Tom.	Labvakar, Tom.
Close, Sesame!	Sezam, aizveries!
Do you know your child's father's blood type?	Vai tu zini tava bērna tēva asins grupu?
I had a feeling something like that was going to happen.	Man bija priekšnojauta, ka kaut kas tāds notiks.
You are in danger.	Jūs esat briesmās.
Bedouins live in the desert.	Beduīni dzīvo tuksnesī.
I saw Nils, too.	Es arī redzēju Nilsi.
That is a very sharp knife!	Tas ir ļoti ass nazis!
This is not his handwriting.	Tas nav viņa rokraksts.
Stay home.	Paliec mājās.
I'm not a pirate.	Neesmu pirāts.
It's a snowman.	Tas ir sniegavīrs.
Where did he go last Friday?	Kur viņš aizgāja pagājušajā piektdienā?
That is mine. I don't know where yours is.	Tas ir mans. Es nezinu, kur ir tavs.
That's mine. I don't know where yours is.	Tas ir mans. Es nezinu, kur ir tavs.
There's one question I would like to ask you.	Ir viens jautājums, ko es vēlētos jums uzdot.
Only certain snakes are venomous but I fear all of them.	Tikai dažas čūskas ir indīgas, bet es baidos no tām visām.
I knew that Tom wasn't a reckless young fellow.	Es zināju, ka Toms nav pārgalvīgs jauneklis.
She carelessly walked through the square.	Viņa bezrūpīgi gāja pa laukumu.
The research casts new light on the issue.	Šajā jautājumā pētījumi dod jaunu skaidrību.
Suddenly, lightning struck one of the most ancient trees in the forest.	Pēkšņi zibens skāra vienu no senākajiem kokiem mežā.
Ziri ran his finger down Rima's chest and abdomen.	Ziri slidināja savu pirkstu lejup pa Rimas krūtīm un vēderu
You handle your cooking and I handle my garden, OK?	Tu tiec galā ar ēdiena gatavošanu, un es tieku galā ar savu dārzu, labi?
I do not understand anything.	Es neko nesaprotu.
Is it even possible?	Vai tas maz ir iespējams?
At least cereal has a long shelf life.	Vismaz graudaugu uzglabāšanas laiks ir ilgs.
Ziri was well.	Ziri bija labi.
Look at that little hummingbird.	Paskat uz to mazo kolibri.
Language was designed to hide feelings.	Valoda tika izveidota, lai slēptu jūtas.
The chip shortage has crimped the world’s ability to produce automobiles.	Mikroshēmu trūkums ir samazinājis pasaules spēju ražot automašīnas.
We must stand up for what's right.	Mums ir jāiestājas par to, kas ir pareizi.
Tom is looking for someone who can babysit his kids Monday night.	Toms meklē kādu, kas varētu auklēt viņa bērnus pirmdienas vakarā.
The number 54 is acceptable to speakers of Cantonese, for whom it means "not dead." Chinese prefer the number 3, the "life" or "birth" number. Japanese and Chinese people have different cultures, of course.	Skaitlis 54 ir pieņemams kantoniešu valodas runātājiem, kuriem tas nozīmē "nav miris". Ķīnieši dod priekšroku skaitlim 3, "dzīves" vai "dzimšanas" skaitlim. Protams, japāņiem un ķīniešiem ir dažādas kultūras.
This is above reason.	Tas ir pāri iemeslam.
He disdained bribery.	Viņš nicināja kukuļdošanu.
Where's the pine forest?	Kur ir priežu mežs?
Nice to meet you!	Prieks iepazīties!
Out of the overflow of the heart, the mouth speaks.	No sirds pārpilnības mutē runā.
The hungry lions were eagerly anticipating the arrival of the wildebeest on their annual migration to the green pastures of the Maasai Mara.	Izsalkušās lauvas ar nepacietību gaidīja gnu ierašanos savā ikgadējā migrācijā uz Maasai Mara zaļajām ganībām.
Good morning, nice to meet you.	Labrīt, jauki tevi satikt.
Of course, being motivated helps.	Protams, būt motivētam palīdz.
Peace is the priority.	Miers ir prioritāte.
Break free from the chains that bind you!	Atbrīvojieties no ķēdēm, kas jūs sasaista!
Ziri won't let that dog out of his sight.	Ziri neizlaidīs to suni no redzesloka.
Catch!	Noķeriet!
Ziri became a successful songwriter.	Ziri kļuva par veiksmīgu dziesmu autoru.
She waved.	Viņa pamāja.
She was waving.	Viņa māja.
Miners occasionally find enormous caves when they drill through a stone wall.	Kalnrači reizēm atrod milzīgas alas, kad viņi urbjas cauri akmens sienai.
It's a story full of gnomes, elves, fairies, and other similar wondrous characters.	Tas ir stāsts, kas pilns ar rūķiem, elfiem, fejām un citiem līdzīgiem brīnumainiem varoņiem.
A group of elves accompany him.	Bariņš elfu sastāda viņam kompāniju.
You would make a good father.	Tu būtu labs tēvs.
Ziri was sick with self-disdain.	Ziri bija apsēsts ar sevis nicināšanu.
My family lives in the city.	Mana ģimene dzīvo pilsētā.
I don't like eating tomatoes.	Man nepatīk ēst tomātus.
The president likes to travel.	Prezidentam patīk ceļot.
This winter we will burn lots of wood.	Šajā ziemā mēs nokurināsim daudz malkas.
Abstract art became popular in the early 20th century.	Abstraktā māksla kļuva populāra 20. gadsimta sākumā.
Start living your dream.	Sāc dzīvot savu sapni.
Season with salt and pepper and leave to cook for about ten minutes, stirring occasionally.	Ieziež ar sāli un pipariem un atstāj gatavoties apmēram desmit minūtes, laiku pa laikam maisot.
My favorite drink is green tea.	Mans mīļākais dzēriens ir zaļā tēja.
"Does Tom still drink?" "No, he's been sober for two years."	''Vai Toms vēl dzer?'' ''Nē, viņš jau divus gadus ir skaidrā.''
Traveling by train	Brauciens ar vilcienu
Let's go to the market!	Lesim uz tirgu!
Where did you go on holiday?	Kur tu biji atvaļinājumā?
What will the weather be like today?	Kāds šodien būs laiks?
Hello, Peter, how are you?	Sveiks, Pēter, kā iet?
Hello, Janis, I'm well, and you?	Sveiks, Jāni! Paldies, labi, un tev?
This is my wife Anda.	Te ir mana sieva Anda
Good day! A pleasure to meet you.	Labdien! Prieks iepazīties.
Grate the carrots finely.	Burkānus smalki sarīvē.
Why is everyone so calm?	Kāpēc visi ir tik mierīgi?
Tom was waving.	Toms māja.
Elves, dwarves, trolls and fairies live in harmony with humans.	Elfi, rūķi, troļļi un laumiņas dzīvo harmonijā ar cilvēkiem.
Elves live longer than humans.	Elfi dzīvo ilgāk par cilvēkiem.
We'll let you know what's new.	Mēs jums paziņosim, kas jauns.
We will let you know what's new.	Mēs jums paziņosim, kas jauns.
Australia is one of the biggest gold producers in the world.	Austrālija ir viena no lielākajām zelta ražotājām pasaulē.
Facebook controls your screen life. Meta will control your whole life.	Facebook kontrolē jūsu ekrāna dzīvi. Meta kontrolēs visu tavu dzīvi.
Nan pampers her grandchildren.	Oma lutina savus mazbērnus.
Tom comes from the Pleiades.	Toms nāk no Plejādēm.
Tom tried to catch the children's attention.	Toms centās pievērst bērnu uzmanību.
The one doesn't preclude the other.	Viens neizslēdz otru.
I prefer tea with no sugar.	Es dodu priekšroku tējai bez cukura.
Put that sharp tongue back in the drawer!	Ieliec to aso mēli atpakaļ atvilktnē!
Darkness from the storm and then nightfall precluded further battle that day.	Negaisa un nakts tumsa todien neļāva turpināt cīņu.
My aunt does not have siblings.	Manai tantei nav brāļu un māsu.
I drink green tea, not black.	Es dzeru zaļo tēju, nevis melno.
His belt is black.	Viņa josta ir melna.
Sodium is an ubiquitous element.	Nātrijs ir visuresošs elements.
Ziri waved back.	Zirī māja atapkaļ.
Were there many passengers on your plane?	Vai jūsu lidmašīnā bija daudz pasažieru?
Ziri tried to keep himself motivated.	Ziri centās saglabāt motivāciju.
They went all together.	Viņi gāja visi kopā.
Ziri got the feeling he was being watched.	Ziri radās sajūta, ka viņu vēro.
I'm not motivated enough today.	Es šodien neesmu pietiekami motivēts.
Ziri is addicted to hikes.	Ziri ir aizrāvies ar pārgājieniem.
But their laughter is a way to socially bond with each other and is based on a primitive reflex similar to tickling.	Taču viņu smiekli ir veids, kā sociāli saprasties vienam ar otru, un balstās uz primitīvu refleksu, kas līdzinās kutināšanai.
Ziri has just moved.	Zirī ir nupat pārvācies.
I'd like an avocado ice cream with sprinkles.	Man gribētos avokado saldējumu ar drupačām.
People would occasionally get lost in those woods.	Cilvēki reizēm apmaldās tajos mežos.
These houses were built last century.	Šīs mājas uzceltas pagājušajā gadsimtā.
Ziri will never go back to that trail.	Ziri nekad neatgriezīsies uz tās takas.
The wall was higher than the fence.	Siena bija augstāka par žogu.
The snow was gone.	Sniegs bija izkusis.
The forest is silent.	Mežs ir kluss.
Poachers occasionally wander on to Ziri's property.	Malumednieki laiku pa laikam klīst Ziri īpašumā.
Ziri still occasionally goes to that lake.	Ziri joprojām ik pa laikam dodas uz to ezeru.
Is Ziri following me?	Vai Ziris man seko?
Ziri lives in a different part of Algeria.	Ziri dzīvo citā Alžīrijas daļā.
Ziri was alone in the woods.	Ziri bija viens pats mežā.
The trees were moving with a gentle push of the wind.	Koki kustējās, pūšot maigam vējam.
Ziri saw a strange yellow light coming from the woods.	Ziri ieraudzīja dīvainu dzeltenu gaismu, kas nāk no meža.
Drug prohibition doesn't aim to help addicts, but to exploit their vulnerability.	Narkotiku aizlieguma mērķis nav palīdzēt narkomāniem, bet gan izmantot viņu ievainojamību.
I bought an avocado last night.	Vakar vakarā nopirku avokado.
Well, that's going to depend on the situation.	Nu, tas būs atkarīgs no situācijas.
The capital of Latvia is Riga.	Latvijas galvaspilsēta ir Rīga.
There's no comparing them!	Tos nevar salīdzināt!
One day a week he fasts for health reasons.	Vienu dienu nedēļā viņš gavē veselības apsvērumu dēļ.
Ziri locked all the doors.	Zirī aizslēdza visas durvis.
In laboratory experiments, the research group tested a variety of essential oils from eight plants, including thyme, basil, peppermint and cinnamon.	Laboratorijas eksperimentos pētnieku grupa pārbaudīja dažādas ēteriskās eļļas no astoņiem augiem, tostarp no timiāna, bazilika, piparmētras un kanēļa.
He was rebellious.	Viņš bija dumpīgs.
Ziri didn't go to school because of a fever.	Zirī nedevās uz skolu drudža dēļ.
Being kind is a fundamental element of who I am.	Laipnam būt, ir būtisks elements tam, kas es esmu.
Dad devoted his entire life to growing this company.	Tētis visu savu dzīvi veltīja šī uzņēmuma attīstībai.
Old Latvian traditions are much more real and truer than today's generally accepted holidays.	Senlatviešu tradīcijas ir daudz īstākas un patiesākas, nekā mūsdienās vispārpieņemtie svētki.
They got played.	Viņi tika apspēlēti.
Human doesn't run on batteries.	Cilvēks nedarbojas uz baterijām.
Taste must be cultivated.	Gaume ir jākopj.
You have to cultivate your taste.	Sava gaume ir jākopj.
Those are not sentences with a deeper thought.	Tie nav teikumi ar dziļāku domu.
It's an art not to panic.	Tā ir māksla nekrist panikā.
It was entirely my fault.	Tā bija pilnībā mana vaina.
I avoid drinking coffee in the morning.	No rīta es izvairos dzert kafiju.
Everyone looks at me as if I'm a strange person.	Visi uz mani skatās tā, it kā es būtu savādnieks.
Everyone looks at me like I'm weird.	Visi uz mani skatās tā, it kā es būtu savādnieks.
Everybody looks at me as if I'm an odd man.	Visi uz mani skatās tā, it kā es būtu savādnieks.
People usually get the kind of answers they expect.	Cilvēki parasti saņem tāda veida atbildes, kādas paši sagaida.
We survive by holding out hope for a different tomorrow.	Mēs izdzīvojam, cerot uz savādāku rītdienu.
"That can happen occasionally." "Occasionally? It happens all the time!"	"Tas var notikt reizēm." "Reizēm? Tas notiek visu laiku!"
He deserves to be listened to.	Viņš ir pelnījis, lai viņā ieklausītos.
Unfounded praise is like an insult.	Nepamatota uzslava ir kā aizvainojums.
I voted "remain".	Es balsoju par palikšanu.
Nobody can hold you back from your potential.	Neviens nevar atturēt tevi no tava potenciāla.
To be careful does not mean to be afraid.	Uzmanīties nenozīmē baidīties.
I meant to do that.	Es gribēju to darīt.
I don't deserve your kindness.	Es neesmu pelnījis tavu laipnību.
Air does not belong to everyone.	Gaiss nepieder visiem.
She decided to move to Belgium.	Viņa nolēma pārcelties uz Beļģiju.
Laught is best medicine.	Smiekli ir labākās zāles.
I'm just sensitive to energies.	Es vienkārši esmu jūtīgs pret enerģijām.
People has very used to look outside of themselves.	Cilvēki ir ļoti pieraduši skatīties ārpus sevis.
People are very used to looking at the material side of life.	Cilvēki ir ļoti pieraduši skatīties uz materiālo dzīves pusi.
It may not always be so easy to see the beauty behind the physical.	Tas ne vienmēr var būt tik vienkārši saskatīt skaistumu aiz fiziskā.
To live a simple lifestyle does not mean to have a poverty mindset.	Dzīvot vienkāršu dzīvesveidu nenozīmē nabadzības domāšanu.
You need to correct these errors.	Tev ir jāizlabo šīs kļūdas.
You didn't ask the right questions.	Tu neuzdevi pareizos jautājumus.
It's already stopped raining.	Lietus jau ir mitējies.
He's decided not to drink.	Viņš ir nolēmis nedzert.
It is important to distinguish mockery from laughing.	Ir svarīgi atšķirt ņirgāšanos no smiešanās.
The flowers bloomed in the garden.	Dārzā ziedēja puķes.
The leaves rustled in the wind.	Lapas čaukstēja vējā.
The fire crackled in the fireplace.	Kamīnā sprakšķēja uguns.
Every day that you're alive, you should smile at life.	Katru dienu, ka esi dzīvs, vajadzētu pasmaidīt par dzīvi.
I got a new passion.	Man radās jauna aizraušanās.
Routines are not my thing.	Rutīnas nav mana stihija.
Why do you get angry when I talk?	Kādēļ tu kļūsti nikns, kad es runāju?
I guess I have to do physical exercises more often.	Man šķiet, ka man biežāk jāveic fiziski vingrinājumi.
The forest is silent today.	Mežs šodien klusē.
We can't find the virus in your blood.	Mēs nevaram atrast vīrusu jūsu asinīs.
However, my shoulder hurts.	Tomēr man sāp plecs.
We need a surgeon.	Mums vajag ķirurgu.
How long is the surgery?	Cik ilgi notiek operācija?
It's easy to miss something you're not looking for.	Ir viegli palaist garām kaut ko, ko nemeklējat.
I don't want to destroy.	Es negribu iznīcināt.
The black tea has more tannin since black tea leaves are more oxidized.	Melnajā tējā ir vairāk tanīna, jo melnās tējas lapas ir vairāk oksidētas.
How seriously should we take this?	Cik nopietni mums tas būtu jāuztver?
You'll have to manage without my help this time.	Šoreiz tev būs jāiztiek bez manas palīdzības.
You can't stop me from living my life the way I want to.	Tu nevari man liegt dzīvot tā, kā es vēlos.
After a little while, it became dark.	Pēc brītiņa kļuva tumšs.
He's not a vegan anymore.	Viņš vairs nav vegāns.
Unfortunately, it has always been that way.	Diemžēl, visu laiku tā ir bijis.
The bird started to sing and made my day brighter.	Putns sāka dziedāt un padarīja manu dienu gaišāku.
One teaspoon of Sirius B is so dense that it weighs 5 tons.	Viena tējkarote Sirius B ir tik blīva, ka sver 5 tonnas.
A small bird sang loudly.	Mazs putniņš skaļi dziedāja.
People born under the sun in Libra are adorable.	Cilvēki, kas dzimuši zem saules Svaru zīmē, ir burvīgi.
The devil doesn't like generous millionaires.	Velnam nepatīk dāsni miljonāri.
Tom grabbed the microphone and started singing.	Toms paķēra mikrofonu un sāka dziedāt.
